Row Labels,Sum of NUM_LICENSED_BEDS,Sum of NUM_STAFFED_BEDS,Sum of NUM_ICU_BEDS,Sum of ADULT_ICU_BEDS,Sum of PEDI_ICU_BEDS,Sum of Potential_Increase_In_Bed_Capac,Sum of BED_UTILIZATION,Sum of AVG_VENTILATOR_USAGE
1001,85,55,6,6,0,30,0.623113334,2
1003,386,362,51,51,0,24,2.248811513,8
1005,74,30,5,5,0,44,0.430639744,2
1007,35,25,4,4,0,10,0.43090412,1
1009,25,25,6,6,0,0,0.499068499,2
1011,61,30,5,5,0,31,0.212876707,1
1013,72,44,7,7,0,28,0.187110841,2
1015,486,435,30,30,0,51,1.294689894,15
1017,115,84,15,15,,31,0.398726463,0
1019,60,45,8,8,0,15,0.242531642,1
1021,30,26,6,6,0,4,0.285458386,2
1023,25,25,4,4,0,0,0.234739721,0
1025,85,56,10,10,0,29,0.579569459,2
1027,45,46,4,4,0,-1,0.280643255,2
1031,131,99,7,7,0,32,0.238051757,2
1033,383,300,22,22,0,83,0.511570297,6
1035,58,44,8,8,0,14,0.29383561,0
1039,187,128,13,13,0,59,0.640019804,4
1041,93,57,5,5,0,36,0.12602739,2
1043,185,185,12,12,0,0,0.980500668,5
1045,89,77,6,6,0,12,0.264935076,2
1047,175,109,23,23,0,66,0.404599726,2
1049,134,97,12,12,0,37,0.292218626,3
1051,138,70,11,11,0,68,0.591940135,3
1053,142,95,14,14,0,47,0.691453874,4
1055,739,590,85,85,0,149,2.224796593,14
1057,61,45,8,8,0,16,0.233729064,2
1059,125,74,11,11,0,51,0.664230347,3
1061,83,73,6,6,0,10,0.131431788,2
1063,20,20,4,4,0,0,0.241643831,0
1065,39,28,5,5,0,11,0.260861069,0
1069,790,784,72,72,22,6,2.984443665,18
1071,170,92,10,10,0,78,0.628269017,2
1073,4768,3816,393,393,264,952,8.185886316,92
1077,263,233,36,36,0,30,0.557444572,6
1079,98,43,6,6,0,55,0.151322082,2
1081,314,299,20,20,0,15,0.688101888,10
1083,102,97,18,18,0,5,0.971104324,6
1087,143,143,0,0,,0,,0
1089,1241,1240,99,99,49,1,2.660178959,24
1091,99,37,5,5,0,62,0.366456866,2
1093,120,97,8,8,0,23,0.393788218,3
1095,150,150,20,20,0,0,0.435119539,7
1097,1930,1524,246,246,118,406,4.455416679,31
1099,94,49,8,8,0,45,0.116466314,2
1101,1204,1018,86,86,65,186,3.18582809,20
1103,273,222,23,23,0,51,0.498951018,3
1109,97,97,9,9,0,0,0.18395707,2
1111,15,15,3,3,0,0,0.223892108,1
1113,128,105,10,10,0,23,1.344410509,4
1115,40,40,6,6,0,0,0.586369872,2
1117,286,246,32,32,0,40,1.155744493,6
1119,33,33,6,6,0,0,0.453300118,0
1121,290,207,14,14,0,83,0.466252357,4
1123,127,80,14,14,0,47,0.555457801,2
1125,1003,804,57,57,51,199,3.049539745,33
1127,267,207,12,12,0,60,0.287485927,4
1129,25,15,3,3,0,10,0.431780815,1
1131,30,21,4,4,0,9,0.065753423,0
1133,49,49,4,4,0,0,0.28303048,2
2020,1102,979,109,109,76,123,3.026601195,21
2050,50,34,6,6,0,16,0.39991942,1
2070,16,16,3,3,0,0,0.148458898,1
2090,175,145,13,13,0,30,0.395463735,2
2110,73,45,9,9,0,28,0.365966529,2
2122,77,76,11,11,0,1,1.218078464,3
2130,25,25,4,4,0,0,0.38246575,2
2150,25,24,4,4,0,1,0.200114161,2
2170,125,74,14,14,0,51,0.669270635,3
2180,18,18,3,3,0,0,0.401674271,1
2185,10,14,3,3,0,-4,0.177103713,1
2188,17,17,3,3,0,0,0.240612403,0
2195,12,12,2,2,0,0,0.26826483,0
2220,25,27,4,4,0,-2,0.338609844,1
2261,24,24,4,4,0,0,0.442858517,1
2275,8,8,1,1,0,0,0.287568301,0
4001,162,162,29,29,0,0,1.026460893,5
4003,160,135,22,22,0,25,1.047910362,6
4005,418,396,61,61,18,22,2.266113557,12
4007,50,50,8,8,0,0,0.952646703,4
4009,176,57,10,10,0,119,0.608855203,2
4012,42,42,6,6,0,0,0.480712317,2
4013,11544,9809,1137,1137,335,1735,32.05138063,281
4015,610,551,80,80,0,59,1.585539967,20
4017,188,176,24,24,0,12,1.859696403,5
4019,3367,2860,377,377,159,507,9.043637753,59
4021,401,401,39,39,0,0,1.406980831,10
4023,25,25,4,4,0,0,0.275835603,2
4025,385,302,43,43,0,83,2.591714501,12
4027,456,447,42,42,20,9,1.164558858,7
5001,74,74,13,13,0,0,0.279664524,3
5003,33,25,6,6,0,8,0.403835624,2
5005,268,170,17,17,0,98,0.514519036,4
5007,342,311,34,34,8,31,1.595693603,7
5009,174,120,24,24,0,54,0.195867583,3
5011,33,25,4,4,0,8,0.226958901,2
5015,40,40,8,8,0,0,0.478757992,4
5017,35,35,4,4,0,0,0.921775997,2
5019,25,25,4,4,0,0,0.436712325,2
5021,25,25,4,4,0,0,0.496547937,1
5023,25,25,4,4,0,0,0.359780818,1
5027,49,30,6,6,0,19,0.262739718,2
5029,25,25,4,4,0,0,0.315178096,2
5031,730,561,74,74,12,169,2.23976019,17
5033,103,35,8,8,0,68,0.281954885,2
5035,65,63,2,2,0,2,0.595420599,1
5037,25,15,3,3,0,10,0.565296829,2
5039,25,22,4,4,0,3,0.089414693,0
5041,50,50,8,8,0,0,0.514082178,2
5043,49,49,5,5,0,0,0.404025733,2
5045,357,355,25,25,0,2,1.870748386,6
5047,25,25,4,4,0,0,0.107945204,1
5049,25,25,4,4,0,0,0.413479447,2
5051,562,423,48,48,0,139,2.536005049,16
5055,129,114,8,8,0,15,0.285147786,3
5057,79,67,8,8,0,12,0.092496425,2
5059,72,64,6,6,0,8,0.395590752,2
5061,20,20,6,6,0,0,0.292054802,2
5063,235,184,12,12,0,51,0.436941624,4
5065,25,25,4,4,0,0,0.184767127,1
5069,471,271,34,34,0,200,0.432047725,7
5071,90,57,8,8,0,33,0.215236723,2
5075,25,25,4,4,0,0,0.302762419,2
5081,25,25,4,4,0,0,0.10871233,1
5083,41,40,7,7,0,1,0.351426929,3
5091,62,50,0,0,0,12,0.618191779,0
5093,124,124,9,9,0,0,0.467918634,3
5103,98,87,8,8,0,11,0.148575023,2
5107,155,127,6,6,0,28,0.095178515,2
5113,65,41,6,6,0,24,0.284062803,2
5115,170,137,11,11,0,33,0.407779217,4
5119,4324,3570,220,220,168,754,8.578488767,63
5121,50,32,2,2,0,18,0.176968858,1
5123,118,56,6,6,0,62,0.282778859,2
5125,257,207,16,16,0,50,1.164345801,3
5127,24,24,4,4,0,0,0.134703189,1
5131,1081,779,80,80,25,302,3.919452727,27
5137,25,25,4,4,0,0,0.20767124,1
5139,166,111,16,16,0,55,0.325525433,3
5141,25,25,4,4,0,0,0.520657539,2
5143,1068,836,78,78,34,232,4.458800703,17
5145,465,272,17,17,0,193,0.929591596,10
5149,76,55,9,9,0,21,0.676225722,3
6001,3464,3570,331,331,151,-106,9.94199574,74
6005,52,52,6,6,0,0,0.470547944,3
6007,401,471,47,47,6,-70,2.006689191,19
6009,25,25,5,5,0,0,0.344219178,2
6013,1696,1636,172,172,97,60,4.452136129,44
6015,49,39,6,6,0,10,0.518018961,3
6017,190,189,28,28,0,1,0.806522429,6
6019,1848,1713,418,418,104,135,4.72098881,50
6021,47,15,3,3,0,32,1,1
6023,276,233,27,27,5,43,2.749514848,12
6025,268,268,28,28,0,0,0.835554272,9
6027,29,29,5,5,0,0,0.484931514,2
6029,1535,1497,160,160,77,38,5.916382119,33
6031,173,142,22,22,0,31,0.514389515,5
6033,62,50,8,8,0,12,1.313862979,5
6035,25,25,4,4,0,0,0.356383562,1
6037,23579,22419,2352,2352,1147,1160,57.39261916,523
6039,464,464,52,52,116,0,0.925614446,18
6041,441,441,47,47,8,0,1.960956931,15
6043,18,18,3,3,0,0,0.709589064,2
6045,142,100,14,14,2,42,1.845315069,6
6047,242,242,24,24,0,0,0.909373254,12
6049,20,20,4,4,0,0,0.460445195,2
6051,17,17,2,2,0,0,0.268815458,1
6053,678,709,47,47,34,-31,2.162586659,14
6055,510,318,48,48,6,192,1.508915514,9
6057,137,129,10,10,0,8,1.071999997,7
6059,5982,5777,703,703,316,205,14.67799741,141
6061,748,693,70,70,64,55,1.832674503,20
6063,35,36,8,8,0,-1,0.913720131,3
6065,3537,3417,385,385,107,120,10.05637005,89
6067,3295,3159,377,377,192,136,9.074079782,102
6069,25,49,8,8,0,-24,0.334470212,2
6071,4789,4650,611,611,305,139,12.92171367,107
6073,6518,6345,698,698,320,173,13.47193491,175
6075,2860,2784,404,404,129,76,6.024590231,44
6077,2161,1334,110,110,79,827,4.393833101,47
6079,780,501,63,63,22,279,1.661083996,13
6081,2328,1889,133,133,16,439,2.534615781,21
6083,826,631,84,84,51,195,3.025049508,26
6085,4382,4295,445,445,276,87,6.828091025,87
6087,372,354,27,27,24,18,2.157612801,13
6089,590,576,96,96,16,14,2.12724264,35
6093,61,50,8,8,0,11,0.833753437,4
6095,1519,1017,104,104,16,502,2.832557827,17
6097,817,824,82,82,12,-7,3.701509766,30
6099,1394,1380,123,123,63,14,3.468425408,51
6101,30,30,2,2,0,0,0.225831702,0
6103,92,65,11,11,0,27,0.553536475,4
6105,25,25,4,4,0,0,0.237369865,1
6107,830,746,84,84,15,84,1.404361881,17
6109,72,84,6,6,0,-12,0.506881952,5
6111,1379,1388,162,162,76,-9,3.646306727,35
6113,122,125,14,14,0,-3,0.951171011,7
6115,221,149,24,24,6,72,0.707347453,12
8001,1559,1454,232,232,148,105,3.364668548,39
8003,49,49,6,6,0,0,0.377914459,2
8005,1241,1031,148,148,45,210,5.206520915,26
8007,11,11,2,2,0,0,0.295641333,1
8009,23,15,3,3,0,8,0.328219175,2
8013,856,715,72,72,44,141,3.133992046,14
8014,40,22,4,4,0,18,0.286924034,1
8015,25,25,2,2,0,0,0.410191774,2
8017,25,11,2,2,,14,0.056787048,1
8021,17,17,3,3,0,0,0.172925055,1
8029,49,49,6,6,0,0,0.273693025,2
8031,3071,2000,294,294,126,1071,4.85181837,26
8035,778,771,70,70,44,7,2.786693096,13
8037,56,56,5,5,0,0,0.249070451,2
8041,1412,1294,130,130,130,118,3.510163277,25
8043,25,25,4,4,0,0,0.595178068,2
8045,103,53,8,8,2,50,1.237799346,4
8049,23,21,3,3,0,2,0.485453367,0
8051,24,20,3,3,0,4,0.233424664,2
8055,20,16,3,3,0,4,0.134075344,0
8059,641,474,104,104,20,167,1.707307868,17
8061,25,25,4,4,0,0,0.648767114,0
8063,19,19,3,3,0,0,0.243835613,0
8065,25,8,1,1,0,17,0.094863012,1
8067,94,94,13,13,0,0,0.651102573,2
8069,742,712,64,64,25,30,4.243592799,25
8071,25,25,4,4,0,0,0.28701371,2
8073,15,15,3,3,0,0,0.172420084,0
8075,25,25,4,4,0,0,0.324054807,2
8077,495,399,35,35,0,96,1.982950181,13
8081,25,25,4,4,0,0,0.353095889,2
8083,25,25,4,4,0,0,0.384547949,2
8085,75,50,8,8,0,25,0.366520554,2
8087,75,61,10,10,0,14,0.309278533,3
8089,25,522,5,5,0,-497,0.490821928,2
8095,40,40,7,7,0,0,1.012639284,0
8097,25,25,4,4,0,0,0.254575342,2
8099,25,25,4,4,0,0,0.32734248,1
8101,1252,770,17,17,0,482,2.145425498,12
8103,35,35,6,6,0,0,0.960438341,2
8105,17,17,3,3,0,0,0.396937966,2
8107,39,39,4,4,0,0,0.223814547,2
8115,15,9,2,2,0,6,0.222831056,0
8117,35,34,8,8,0,1,0.252538264,2
8119,15,15,3,3,0,0,0.294611871,1
8123,428,225,33,33,0,203,0.523677349,7
8125,30,30,6,6,0,0,0.371404111,1
9001,1694,1694,173,173,26,0,5.456516922,44
9003,3065,2900,476,476,118,165,6.711029956,62
9005,157,157,21,21,0,0,0.794911504,7
9007,714,714,40,40,0,0,1.514536262,7
9009,1721,1721,201,201,107,0,5.901467755,52
9011,419,419,25,25,13,0,1.357065856,12
9013,209,209,16,16,0,0,1.751556993,4
9015,144,144,14,14,0,0,1.036775589,5
10001,404,414,29,29,15,-10,2.348140478,12
10003,2094,1712,183,183,6,382,5.972167403,80
10005,567,507,52,52,0,60,1.79424803,13
11001,4098,3090,407,407,113,1008,8.035352394,103
12001,2050,1553,233,233,130,497,2.499325752,52
12003,1163,81,4,4,0,1082,1.127775595,0
12005,707,676,77,77,32,31,2.248651475,20
12007,49,25,4,4,0,24,0.445589036,2
12009,1807,1867,288,288,0,-60,5.732254386,54
12011,6025,4712,525,525,191,1313,12.4516888,93
12013,25,15,3,3,0,10,0.500456631,2
12015,715,607,51,51,7,108,1.521114498,19
12017,332,332,40,40,0,0,1.140625834,14
12019,503,459,42,42,16,44,1.938540518,20
12021,633,773,81,81,19,-140,2.877886832,23
12023,468,456,28,28,0,12,0.962068081,7
12027,49,49,8,8,0,0,0.173609167,2
12031,3456,3119,416,416,156,337,6.583025649,90
12033,1648,1258,111,111,82,390,2.848306417,40
12035,99,99,18,18,0,0,0.904469371,3
12037,25,25,4,4,0,0,0.064657532,1
12039,949,24,4,4,0,925,0.19703196,0
12045,19,19,3,3,0,0,0.20273973,2
12049,25,25,4,4,0,0,0.911561668,1
12051,25,25,3,3,0,0,0.125150681,2
12053,616,546,44,44,10,70,3.120888114,14
12055,273,259,38,38,0,14,0.974523306,8
12057,4056,3564,460,460,205,492,6.817093149,98
12059,20,20,3,3,0,0,0.456986308,2
12061,566,511,43,43,0,55,1.662216365,13
12063,100,66,7,7,0,34,0.525695324,3
12069,851,783,129,129,0,68,2.907911301,19
12071,1614,1243,151,151,152,371,3.834919155,91
12073,1208,822,61,61,30,386,3.075918645,36
12079,25,25,4,4,0,0,0.435616434,2
12081,895,867,113,113,6,28,3.199681997,21
12083,910,829,116,116,0,81,3.845037967,30
12085,388,366,66,66,0,22,1.952576131,17
12086,7842,7941,858,858,258,-99,14.46226981,192
12087,147,129,14,14,0,18,0.45390675,6
12089,62,54,9,9,0,8,0.554287136,3
12091,493,441,51,51,10,52,1.721702576,15
12093,100,100,8,8,0,0,0.474712342,3
12095,3043,4291,349,349,295,-1248,5.375474572,67
12097,628,575,66,66,24,53,2.195524216,14
12099,4440,3967,427,427,136,473,8.720934719,116
12101,1407,1339,143,143,12,68,4.910125822,29
12103,3874,3253,285,285,122,621,8.233148515,76
12105,1736,1590,145,145,45,146,2.534987867,41
12107,99,99,10,10,0,0,0.649757862,5
12109,335,335,47,47,7,0,0.46655491,6
12111,873,728,77,77,6,145,2.25600493,18
12113,355,294,20,20,0,61,2.135123849,6
12115,1542,1312,128,128,33,230,3.707408309,35
12117,345,332,39,39,0,13,2.08495155,9
12119,347,317,62,62,0,30,1.318345785,11
12121,25,25,4,4,0,0,0.388054788,2
12123,48,48,6,6,0,0,0.109817348,2
12125,145,145,25,25,0,0,0.335123301,1
12127,1453,1192,264,264,16,261,4.071528852,33
12131,136,112,28,28,0,24,0.700731792,4
12133,59,25,4,4,0,34,0.585972607,2
13001,49,34,3,3,0,15,0.199113622,2
13005,25,25,4,4,0,0,0.517698646,1
13009,365,285,12,12,0,80,0.34903577,2
13013,56,56,6,6,0,0,0.204060659,2
13015,119,119,21,21,0,0,0.783147216,5
13017,75,48,5,5,0,27,0.219691783,2
13019,63,51,9,9,0,12,0.030889068,1
13021,1184,1017,126,126,77,167,4.076771766,25
13023,25,15,3,3,0,10,0.862465739,1
13027,25,25,4,4,0,0,0.537972629,1
13031,195,184,31,31,0,11,0.52950263,4
13033,40,40,7,7,0,0,0.070479453,1
13035,25,25,4,4,0,0,0.52208221,2
13039,40,40,5,5,0,0,0.454863012,2
13043,25,25,6,6,0,0,0.311013699,2
13045,326,197,28,28,0,129,1.494170427,11
13047,179,36,6,6,0,143,0.107686453,2
13051,1569,1304,89,89,74,265,5.973360002,42
13053,250,250,0,0,,0,,0
13057,126,150,20,20,0,-24,0.939926922,6
13059,597,564,99,99,20,33,1.951869607,16
13063,538,441,35,35,0,97,2.183029205,7
13065,25,15,3,3,0,10,0.467945218,1
13067,1346,1243,98,98,49,103,2.679988295,67
13069,88,86,10,10,0,2,0.527970672,3
13071,168,127,16,16,0,41,1.641299903,3
13075,33,33,6,6,0,0,0.088750519,0
13077,254,250,23,23,10,4,2.18677628,9
13081,73,65,16,16,0,8,0.517471015,3
13083,36,36,6,6,,0,,0
13087,80,80,10,10,0,0,0.19695206,2
13089,2368,1981,307,307,42,387,6.24635601,36
13091,94,40,6,6,0,54,0.363219172,2
13095,691,405,50,50,27,286,0.65292871,9
13097,108,102,8,8,0,6,0.698066056,10
13099,25,25,3,3,0,0,0.360109597,1
13103,25,25,4,4,0,0,0.265643835,2
13105,25,52,4,4,0,-27,0.143308744,2
13107,72,45,8,8,0,27,0.199391171,2
13109,49,49,9,9,0,0,0.067766286,2
13111,50,50,5,5,0,0,0.177479446,2
13113,282,221,66,66,20,61,0.812888026,8
13115,514,435,42,42,0,79,1.404237628,18
13117,304,304,24,24,0,0,0.713799775,7
13119,56,56,8,8,0,0,0.320645779,2
13121,4682,3931,656,656,154,751,8.2252855,88
13127,401,401,12,12,0,0,1.09515518,8
13129,69,69,8,8,0,0,0.642644405,2
13131,60,44,4,4,0,16,0.303860515,2
13133,50,50,8,8,0,0,0.933698624,4
13135,848,854,70,70,42,-6,2.300938427,23
13137,53,53,4,4,0,0,0.300129235,2
13139,657,542,85,85,0,115,0.81093365,20
13143,25,15,3,3,0,10,0.82337898,2
13151,215,215,33,33,16,0,0.740032673,10
13153,276,276,36,36,0,0,1.170141369,11
13155,34,34,6,6,0,0,0.120467365,2
13157,90,28,5,5,0,62,0.122798435,2
13159,17,12,2,2,0,5,0.31940639,0
13161,35,25,4,4,0,10,0.326794535,2
13163,37,37,6,6,0,0,0.12506479,2
13165,25,15,3,3,0,10,0.079279281,1
13173,25,25,4,4,0,0,0.239780828,1
13175,190,145,16,16,0,45,0.536136031,6
13179,64,64,4,4,0,0,0.299726039,2
13185,443,360,48,48,0,83,1.556889057,9
13187,52,,32,32,,52,,0
13189,25,25,4,4,0,0,0.589917779,2
13193,49,22,4,4,0,27,0.024283934,0
13199,109,109,11,11,0,0,1.22413671,6
13201,25,25,4,4,0,0,0.841972589,2
13205,23,25,4,4,0,-2,0.607123315,1
13207,25,25,5,5,0,0,0.450739712,2
13211,25,25,4,4,0,0,0.555178106,1
13213,42,29,5,5,0,13,0.148795471,1
13215,1167,794,69,69,39,373,2.86087361,29
13217,101,94,10,10,6,7,0.486009896,4
13223,112,112,8,8,0,0,0.690704525,9
13225,25,25,4,4,0,0,0.763397276,2
13227,52,52,6,6,0,0,0.699104309,3
13233,25,25,4,4,0,0,0.845369875,2
13235,49,55,6,6,0,-6,0.158007473,2
13241,25,25,4,4,0,0,0.237698629,2
13243,25,25,4,4,0,0,0.162082195,1
13245,2824,1850,402,402,74,974,4.172631383,61
13247,138,138,16,16,0,0,0.758068562,5
13251,25,25,4,4,0,0,0.216657534,1
13253,65,45,8,8,0,20,0.229893461,1
13255,160,160,22,22,0,0,0.578202069,12
13257,96,74,6,6,0,22,0.253942996,2
13261,76,54,9,9,0,22,0.554033458,3
13267,25,25,4,4,0,0,0.290301383,2
13275,264,226,35,35,0,38,0.635761917,7
13277,241,181,20,20,0,60,0.637629628,4
13279,57,52,8,8,0,5,0.769494176,3
13281,25,25,4,4,0,0,0.326356173,1
13285,276,276,20,20,0,0,0.293041497,7
13291,45,39,5,5,0,6,0.50165087,2
13293,115,87,28,28,0,28,0.37228784,2
13297,165,164,7,7,0,1,1.053097665,3
13299,231,134,10,10,6,97,0.518707812,8
13303,56,56,10,10,0,0,0.117808223,2
13305,88,88,12,12,0,0,0.378673732,2
13313,282,245,34,34,0,37,0.457769066,8
13317,25,25,4,4,0,0,0.390356153,1
13321,25,25,4,4,0,0,0.475178093,2
15001,333,296,28,28,0,37,3.979265004,11
15003,2639,2718,155,155,112,-79,6.704405375,37
15007,111,102,10,10,0,9,1.030458139,4
15009,247,247,26,26,0,0,1.296251535,5
16001,1305,1194,97,97,110,111,3.222855419,24
16005,205,137,20,20,16,68,0.585181475,4
16007,21,21,4,4,0,0,0.247358128,1
16009,19,19,3,3,0,0,0.19134824,1
16011,153,131,6,6,0,22,1.508406341,2
16013,25,25,4,4,0,0,0.354958892,1
16017,25,25,4,4,0,0,0.450301379,2
16019,420,254,74,74,26,166,0.933964491,9
16021,20,20,3,3,0,0,0.138767123,0
16023,14,14,2,2,0,0,0.051076323,0
16027,343,293,41,41,12,50,1.28204608,9
16029,25,25,4,4,0,0,0.161424652,1
16031,25,31,6,6,0,-6,0.33796069,2
16035,83,78,4,4,0,5,0.259916604,2
16039,25,21,4,4,0,4,0.383170247,1
16041,20,20,3,3,0,0,0.320410967,0
16045,16,13,2,2,0,3,0.177028447,0
16047,18,16,3,3,0,2,0.45941782,2
16049,41,40,7,7,0,1,0.543634713,1
16053,25,18,4,4,0,7,0.359068811,1
16055,434,401,76,76,14,33,2.275409847,12
16057,25,25,3,3,0,0,0.49205479,2
16059,18,18,3,3,0,0,0.176864535,1
16065,69,67,4,4,14,2,0.270701289,2
16067,25,16,3,3,0,9,0.338698626,1
16069,145,110,9,9,0,35,0.348952055,4
16071,11,11,2,2,0,0,0.326276451,0
16077,10,10,2,2,0,0,0.16630137,0
16079,25,21,4,4,0,4,0.185909986,0
16081,13,13,2,2,0,0,0.124341413,1
16083,224,186,30,30,18,38,0.514702559,4
16085,25,23,4,4,0,2,0.3220548,1
16087,25,19,3,3,0,6,0.132372022,1
17001,307,248,25,25,0,59,0.489284128,10
17005,42,32,6,6,0,10,0.317465752,2
17011,94,69,9,9,0,25,0.62855044,3
17019,680,647,39,39,25,33,1.945247114,13
17021,47,47,8,8,0,0,0.750126988,4
17025,20,20,3,3,0,0,0.309863001,2
17027,70,46,8,8,0,24,0.209084645,2
17029,149,82,14,14,0,67,0.596090853,3
17031,18846,15730,2021,2021,651,3116,34.09278901,455
17033,63,25,4,4,0,38,0.359671235,2
17037,192,192,27,27,0,0,1.168887258,9
17039,25,15,3,3,0,10,0.08127854,0
17043,1928,1723,219,219,45,205,5.539263785,50
17045,25,25,4,4,0,0,0.595945179,1
17049,133,133,10,10,0,0,0.287382841,2
17051,110,29,4,4,0,81,0.34641096,1
17053,41,25,2,2,0,16,0.371835619,2
17055,16,16,3,3,0,0,0.092383564,2
17057,87,43,5,5,0,44,0.448423058,2
17061,25,25,4,4,0,0,0.099178083,0
17063,89,89,8,8,0,0,0.422410339,2
17065,25,25,4,4,0,0,0.349698633,2
17067,18,18,3,3,0,0,0.323896497,1
17069,25,25,4,4,0,0,0.284054786,0
17073,86,50,7,7,0,36,0.493698642,3
17075,25,25,5,5,0,0,0.110136986,2
17077,179,179,25,25,13,0,1.078123182,6
17081,181,171,22,22,0,10,0.777652979,10
17083,65,46,4,4,0,19,0.152114347,2
17085,25,18,3,3,0,7,0.264219165,0
17089,1483,1306,120,120,13,177,3.405148774,32
17091,500,460,27,27,0,40,0.803916991,20
17095,254,177,18,18,0,77,0.626065448,7
17097,1019,826,109,109,0,193,2.827507436,26
17099,171,164,13,13,0,7,0.933452606,5
17101,25,25,4,4,0,0,0.218301371,1
17103,80,66,6,6,0,14,0.325944364,3
17105,42,42,5,5,0,0,0.390737116,2
17107,25,25,4,4,0,0,0.48109588,2
17109,60,45,7,7,0,15,0.310563177,2
17111,370,437,55,55,0,-67,0.94504711,11
17113,370,343,54,54,0,27,0.938594997,6
17115,424,446,35,35,0,-22,0.948139757,13
17117,50,50,8,8,0,0,0.417205468,3
17119,953,648,62,62,0,305,3.007822007,13
17121,149,107,13,13,0,42,0.751664579,6
17125,25,25,4,4,0,0,0.129424661,1
17127,25,25,4,4,0,0,0.404821932,2
17131,22,22,4,4,0,0,0.127397254,0
17135,50,50,9,9,0,0,0.738301367,4
17137,131,102,9,9,0,29,0.236234218,3
17141,16,17,4,4,0,-1,0.175503626,1
17143,1226,986,115,115,28,240,2.218738347,26
17145,42,42,7,7,0,0,0.737224847,2
17147,16,16,3,3,0,0,0.307191789,1
17149,35,25,4,4,0,10,0.119123287,1
17157,171,171,29,29,0,0,0.986301363,4
17159,134,47,8,8,0,87,0.267793655,2
17161,472,442,27,27,9,30,0.631467432,8
17163,736,556,63,63,0,180,2.038226068,19
17165,102,65,11,11,0,37,0.629191786,3
17167,1159,994,93,93,43,165,2.371268988,26
17169,22,22,4,4,0,0,0.16749689,0
17173,30,30,5,5,0,0,0.126484022,2
17177,100,100,8,8,0,0,0.373671234,4
17179,132,132,12,12,0,0,0.426493913,5
17181,135,113,4,4,0,22,0.719283938,2
17183,198,196,16,16,0,2,0.400502414,6
17185,25,25,4,4,0,0,0.275506854,1
17187,23,23,4,4,0,0,0.151995242,1
17189,50,22,4,4,0,28,0.227272734,1
17191,55,25,4,4,0,30,0.183890417,2
17195,123,121,13,13,0,2,0.734220326,2
17197,1023,852,97,97,0,171,1.640351027,28
17199,327,294,28,28,0,33,0.975880444,9
17201,988,925,99,99,60,63,2.489417702,17
17203,25,25,4,4,0,0,0.132493153,1
18001,25,25,4,4,0,0,0.610082209,2
18003,1630,1630,235,235,101,0,4.265622348,38
18005,225,225,17,17,0,0,0.39505291,7
18009,15,15,4,4,0,0,0.40566209,2
18011,68,68,8,8,0,0,0.291780829,2
18017,165,165,5,5,0,0,0.823258787,3
18019,253,253,22,22,0,0,1.309844911,5
18021,25,25,4,4,0,0,0.078246579,1
18023,25,25,5,5,0,0,0.167232871,2
18027,42,42,5,5,0,0,0.270384878,2
18029,102,102,8,8,0,0,0.841665328,3
18031,25,25,4,4,0,0,0.443178087,2
18033,37,37,8,8,0,0,0.321658641,3
18035,377,377,44,44,23,0,1.694696188,26
18037,111,111,26,26,0,0,0.328890532,3
18039,338,338,35,35,8,0,1.826278239,9
18043,280,269,18,18,0,11,1.62762633,8
18049,25,25,4,4,0,0,0.394191772,2
18051,25,25,5,5,0,0,0.341698617,1
18053,347,347,19,19,0,0,0.996016413,7
18055,25,25,5,5,0,0,0.2820822,2
18057,610,610,90,90,44,0,2.075448945,19
18059,73,73,26,26,0,0,0.36829105,4
18061,25,25,4,4,0,0,0.524493158,2
18063,260,260,28,28,0,0,1.02623409,10
18065,48,48,10,10,0,0,0.454509139,3
18067,250,250,21,21,0,0,1.244441867,10
18069,36,36,6,6,0,0,0.331126332,2
18071,91,91,7,7,0,0,0.26298359,6
18073,25,25,4,4,0,0,0.174027398,2
18075,25,25,4,4,0,0,0.237516344,2
18077,238,238,6,6,0,0,1.067677468,2
18079,25,25,4,4,0,0,0.070684932,1
18081,195,195,6,6,0,0,1.300833657,2
18083,99,99,30,30,0,0,0.557548106,4
18085,88,88,14,14,0,0,0.94495815,3
18087,25,25,4,4,0,0,0.331726015,2
18089,1737,1737,203,203,63,0,7.133255005,66
18091,278,278,34,34,0,0,0.712751418,9
18093,50,50,11,11,0,0,0.646465763,5
18095,303,303,42,42,0,0,1.077023953,14
18097,3862,3862,467,467,244,0,10.59191442,156
18099,160,160,11,11,0,0,2.063504875,4
18103,25,25,4,4,0,0,0.331506848,2
18105,357,357,24,24,18,0,1.618439019,15
18107,29,29,5,5,0,0,0.286348611,2
18109,83,83,10,10,0,0,0.227562308,3
18113,47,47,5,5,0,0,1.08050707,2
18117,24,24,4,4,0,0,0.080936074,2
18123,25,25,4,4,0,0,0.326356173,2
18127,292,292,32,32,14,0,1.08018589,11
18131,25,25,4,4,0,0,0.30717808,1
18133,25,25,6,6,0,0,0.288547933,2
18135,25,25,4,4,0,0,0.124931507,2
18137,25,25,7,7,0,0,0.504219174,3
18139,25,25,4,4,0,0,0.147178084,1
18141,837,837,111,111,42,0,2.38418746,29
18143,25,25,4,4,0,0,0.318575352,2
18145,46,46,6,6,0,0,0.591661692,4
18149,15,15,1,1,0,0,0.22410959,2
18151,25,25,2,2,0,0,0.428931504,2
18153,25,25,4,4,0,0,0.264109582,2
18157,477,477,35,35,31,0,2.960708201,25
18159,25,25,4,4,0,0,0.313643843,2
18163,993,993,136,136,40,0,1.808878273,32
18165,25,25,6,6,0,0,0.203726023,2
18167,494,494,54,54,15,0,2.506046921,12
18169,18,18,3,3,0,0,0.338071465,2
18171,16,16,4,4,0,0,0.354965746,2
18173,338,338,75,75,0,0,2.983242363,5
18175,25,25,4,4,0,0,0.054356165,2
18177,376,376,30,30,0,0,1.424498737,6
18179,55,55,7,7,0,0,0.175641343,2
18181,25,25,4,4,0,0,0.248109594,2
18183,30,30,5,5,0,0,0.393698633,2
19001,25,25,4,4,0,0,0.044273973,0
19003,22,22,4,4,0,0,0.072602741,2
19005,25,25,5,5,0,0,0.263890415,2
19007,45,25,3,3,0,20,0.151123285,2
19009,25,25,4,4,0,0,0.072986305,1
19011,25,25,4,4,0,0,0.1820274,0
19013,675,384,29,29,7,291,1.013192326,9
19015,42,25,4,4,0,17,0.37468493,2
19017,50,37,7,7,0,13,0.486921072,1
19019,120,85,4,4,0,35,1.0619452,0
19021,35,25,4,4,0,10,0.298520535,2
19025,25,25,2,2,0,0,0.125698626,0
19027,116,66,9,9,0,50,0.485023588,1
19029,33,25,4,4,0,8,0.352547944,2
19033,346,205,18,18,0,141,0.560975611,13
19035,83,61,4,4,0,22,1.313095927,1
19037,18,8,1,1,0,10,0.354452044,0
19039,25,25,4,4,0,0,0.28032878,0
19041,99,49,9,9,0,50,0.361867487,1
19043,50,40,7,7,0,10,0.321753427,1
19045,265,120,12,12,0,145,0.533990532,5
19047,25,25,4,4,0,0,0.212164387,2
19049,25,25,4,4,0,0,0.085260272,0
19051,25,25,4,4,0,0,0.098630138,1
19053,25,11,2,2,0,14,0.222665012,1
19055,25,25,4,4,0,0,0.260931522,2
19057,213,136,12,12,0,77,0.461946011,3
19059,49,44,8,8,0,5,0.181569114,2
19061,470,257,21,21,0,213,1.089398526,8
19063,25,22,4,4,0,3,0.221793279,2
19065,50,50,8,8,0,0,0.26936987,1
19067,25,25,4,4,0,0,0.308383554,0
19069,25,25,4,4,0,0,0.156712323,0
19071,25,25,4,4,0,0,0.092712328,1
19073,25,25,4,4,0,0,0.187835619,1
19075,80,25,4,4,0,55,0.097095892,0
19077,25,25,4,4,0,0,0.167780817,0
19079,25,25,4,4,0,0,0.327780813,1
19081,25,25,4,4,0,0,0.281424671,0
19083,35,19,3,3,0,16,0.349800318,2
19085,25,25,4,4,0,0,0.165917814,2
19087,74,25,4,4,0,49,0.180054799,2
19089,19,18,3,3,0,1,0.187366813,2
19091,49,17,3,3,0,32,0.206768736,0
19093,25,25,4,4,0,0,0.224876717,1
19095,25,25,4,4,0,0,0.274958909,0
19097,25,25,4,4,0,0,0.194410965,0
19099,68,48,8,8,0,20,0.165068492,2
19101,25,25,4,4,0,0,0.377424657,1
19103,1383,962,77,77,116,421,1.032353282,27
19105,22,22,4,4,0,0,0.229016185,2
19107,25,25,4,4,0,0,0.200657532,0
19109,25,24,4,4,0,1,0.400913239,2
19111,121,99,12,12,0,22,0.230953604,4
19113,994,495,36,36,32,499,1.014974773,10
19117,25,25,4,4,0,0,0.11539726,2
19119,25,11,2,2,0,14,0.111309521,0
19121,25,25,4,4,0,0,0.172712326,0
19123,33,25,4,4,0,8,0.418739736,2
19125,50,50,7,7,0,0,0.750575364,3
19127,125,41,7,7,0,84,0.304822683,2
19131,25,25,4,4,0,0,0.181479454,0
19133,25,25,4,4,0,0,0.268383563,2
19135,25,25,4,4,0,0,0.131506845,0
19137,25,25,8,8,0,0,0.465205491,1
19139,48,45,5,5,0,3,0.223135471,2
19141,39,39,6,6,0,0,0.425545283,1
19143,25,25,4,4,0,0,0.11463014,1
19145,50,50,6,6,0,0,0.392219171,4
19147,47,24,4,4,0,23,0.193036526,0
19149,25,25,4,4,0,0,0.22673972,2
19151,25,25,4,4,0,0,0.129534245,1
19153,1671,1520,110,110,91,151,3.789537996,48
19155,514,255,29,29,0,259,0.939998299,7
19157,49,49,5,5,0,0,0.234218612,2
19159,16,16,3,3,0,0,0.180479452,0
19161,25,25,4,4,0,0,0.083178081,1
19163,691,432,47,47,6,259,1.387917489,12
19165,25,25,4,4,0,0,0.359671235,2
19167,96,94,15,15,0,2,0.872242257,2
19169,237,175,17,17,0,62,0.868951142,3
19175,25,25,4,4,0,0,0.375780821,2
19177,25,25,4,4,0,0,0.089095891,1
19179,217,88,11,11,0,129,0.222042337,2
19183,25,25,4,4,0,0,0.290301383,1
19185,25,25,4,4,0,0,0.274082184,1
19187,200,46,8,8,0,154,0.678975582,2
19191,25,25,4,4,0,0,0.363945216,2
19193,830,316,34,34,20,514,1.300617456,11
19197,47,47,8,8,0,0,0.482958913,3
20001,25,25,4,4,0,0,0.349917799,2
20003,12,12,2,2,0,0,0.389726013,0
20005,25,25,4,4,0,0,0.365917802,2
20007,35,32,6,6,0,3,1.085579067,0
20009,81,76,11,11,0,5,1.085369319,2
20013,25,25,4,4,0,0,0.350904107,2
20015,126,108,16,16,0,18,0.817252576,5
20019,25,17,3,3,0,8,0.109427884,0
20021,61,46,8,8,0,15,0.367077619,0
20023,16,16,3,3,0,0,0.197602734,0
20025,43,39,6,6,0,4,0.928814113,0
20027,25,17,3,3,0,8,0.631587446,0
20029,25,22,4,4,0,3,0.25828144,1
20031,25,25,4,4,0,0,0.183342472,2
20033,12,12,2,2,0,0,0.208904102,0
20035,74,53,4,4,0,21,0.754187062,4
20037,100,89,16,16,0,11,0.514985979,4
20039,18,21,4,4,0,-3,0.154337898,0
20041,50,34,6,6,0,16,0.749319881,1
20045,148,110,10,10,0,38,0.456961393,3
20047,12,12,2,2,0,0,0.444520533,0
20051,194,149,34,34,0,45,0.370157212,8
20053,20,18,3,3,0,2,0.274885833,0
20055,100,90,8,8,7,10,0.413729072,2
20057,99,60,10,10,0,39,0.188630134,2
20059,44,44,5,5,0,0,0.196495622,2
20061,139,96,6,6,0,43,0.160413757,2
20063,21,21,4,4,0,0,0.236921072,0
20065,20,20,3,3,0,0,0.200547948,1
20067,26,26,5,5,0,0,0.241938889,1
20071,18,18,3,3,0,0,0.260730594,1
20073,25,25,4,4,0,0,0.268712342,0
20075,25,25,4,4,0,0,0.2310137,0
20077,12,25,4,4,0,-13,0.463232875,0
20079,163,134,6,6,0,29,0.494358882,3
20081,13,13,2,2,0,0,0.178925186,0
20083,50,25,4,4,0,25,0.579366088,0
20085,12,12,2,2,0,0,0.32100457,0
20087,25,25,4,4,0,0,0.084383562,0
20089,25,24,4,4,0,1,0.760616422,0
20091,1955,1519,262,262,105,436,7.271302477,23
20093,25,25,4,4,0,0,0.219945207,1
20095,25,25,4,4,0,0,0.184547946,0
20097,15,15,3,3,0,0,0.41534248,0
20099,99,46,5,5,0,53,0.320135742,2
20101,25,25,4,4,0,0,0.62071234,0
20103,100,46,10,10,0,54,0.844873399,4
20105,14,10,2,2,0,4,0.449315071,1
20109,25,25,4,4,0,0,0.185424656,0
20111,25,21,6,6,0,4,0.858186543,2
20113,95,81,15,15,0,14,0.579225868,2
20115,25,25,5,5,0,0,0.434885845,1
20117,25,23,4,4,0,2,0.441453248,2
20119,20,20,3,3,0,0,0.105342463,1
20121,245,104,109,109,0,141,1.007246941,1
20123,25,16,4,4,0,9,1,0
20125,47,47,7,7,0,0,0.227455556,2
20127,25,25,4,4,0,0,0.147506848,1
20129,28,26,5,5,0,2,0.087565862,2
20131,49,41,7,7,0,8,0.491317496,0
20133,25,22,5,5,0,3,0.663636386,2
20135,50,37,6,6,0,13,0.617857024,0
20137,25,25,4,4,0,0,0.127561644,1
20141,25,24,4,4,0,1,0.158904105,0
20143,25,25,4,4,0,0,0.654575348,0
20145,638,121,4,4,0,517,0.902822718,2
20147,25,25,4,4,0,0,0.280000001,0
20149,50,43,7,7,0,7,0.569327265,3
20151,35,35,6,6,0,0,0.305988252,2
20153,24,15,3,3,0,9,0.237990871,1
20155,200,137,20,20,0,63,0.463395521,5
20157,25,25,4,4,0,0,0.620602727,2
20159,25,25,4,4,0,0,0.499397248,1
20161,163,99,10,10,0,64,0.643455774,2
20163,20,16,3,3,0,4,0.337500006,1
20165,25,16,3,3,0,9,1,0
20167,25,20,3,3,0,5,0.325101167,1
20169,392,193,21,21,14,199,0.896910846,4
20171,25,25,4,4,0,0,0.404602736,1
20173,2837,1721,214,214,67,1116,5.023171425,42
20175,69,71,8,8,0,-2,0.283773869,2
20177,1067,735,45,45,40,332,2.077465445,17
20179,18,18,3,3,0,0,0.229680359,0
20181,25,21,4,4,0,4,0.240276694,1
20183,25,16,3,3,0,9,0.325513691,0
20185,25,25,4,4,0,0,0.197041094,0
20187,18,16,3,3,0,2,0.144349322,0
20189,25,17,3,3,0,8,0.194359392,0
20191,25,25,4,4,0,0,0.316493154,0
20193,25,21,1,1,0,4,0.475016296,2
20195,25,25,4,4,0,0,0.428931504,0
20201,50,50,8,8,0,0,1.061698645,1
20203,25,25,4,4,0,0,0.645698607,0
20205,40,40,7,7,0,0,0.603178084,2
20209,1376,1059,167,167,38,317,2.086583853,30
21003,25,25,4,4,0,0,0.753315091,2
21009,180,108,10,10,4,72,0.456037551,3
21013,216,87,14,14,0,129,0.660858035,6
21015,271,166,18,18,0,105,1.596468925,6
21017,58,34,4,4,0,24,0.298630148,2
21019,455,438,38,38,13,17,0.371339202,16
21021,197,170,22,22,0,27,0.432457685,8
21025,55,49,4,4,0,6,0.256080508,3
21027,25,25,4,4,0,0,0.443945199,2
21033,25,25,4,4,0,0,0.264657527,1
21035,152,99,10,10,0,53,0.35527882,3
21037,211,156,26,26,0,55,1.181728601,6
21041,25,25,4,4,0,0,0.169424653,2
21045,24,24,4,4,0,0,0.822831035,2
21047,786,390,18,18,4,396,1.711953849,3
21049,54,54,8,8,0,0,0.449619472,4
21051,49,49,6,6,0,0,0.296337724,2
21053,42,38,7,7,0,4,0.210742608,1
21055,48,48,8,8,0,0,0.170091331,2
21057,25,25,4,4,0,0,0.321095884,2
21059,527,507,32,32,16,20,0.39266625,7
21065,25,25,4,4,0,0,0.526136994,2
21067,2185,1932,367,367,78,253,6.142632157,73
21069,25,52,3,3,0,-27,0.113593258,2
21071,224,177,20,20,0,47,0.880781785,7
21073,173,115,10,10,4,58,0.594187021,4
21081,25,15,3,3,0,10,0.105205476,1
21083,107,95,8,8,0,12,0.450093716,3
21085,75,75,6,6,0,0,0.318465739,3
21087,35,25,4,4,0,10,0.788493156,2
21089,190,135,12,12,0,55,0.559634686,5
21093,465,428,10,10,0,37,1.919840097,7
21095,150,81,7,7,0,69,0.426957548,8
21097,61,61,6,6,0,0,0.169189304,2
21099,25,25,4,4,0,0,0.312000006,1
21101,192,118,12,12,15,74,0.32314837,3
21107,425,445,25,25,6,-20,0.850375086,9
21111,2985,1979,538,538,169,1006,5.327763617,98
21115,72,72,6,6,0,0,0.216095895,2
21117,707,707,46,46,25,0,1.630504727,11
21121,25,25,6,6,0,0,0.341917813,2
21125,150,106,14,14,0,44,0.634944439,5
21127,90,65,6,6,0,25,0.203835621,3
21131,25,25,4,4,0,0,0.436712325,2
21133,90,90,6,6,0,0,0.430319637,6
21137,25,25,4,4,0,0,0.506301343,2
21139,25,25,4,4,0,0,0.33052054,2
21141,75,75,6,6,0,0,0.105351597,2
21145,1057,573,40,40,0,484,1.212583035,18
21151,130,85,12,12,0,45,0.984620988,7
21155,75,63,6,6,0,12,0.110067405,2
21157,25,25,4,4,0,0,0.321643829,2
21161,100,100,5,5,0,0,0.167479455,2
21167,25,25,4,4,0,0,0.416219175,2
21171,49,49,9,9,0,0,0.263740569,1
21173,42,42,4,4,0,0,0.409523815,2
21175,25,25,4,4,0,0,0.076383561,2
21177,90,47,6,6,0,43,0.27309823,2
21179,40,40,4,4,0,0,0.447191775,2
21183,25,25,4,4,0,0,0.344876707,2
21185,90,90,8,8,0,0,0.193515986,2
21193,358,229,32,32,0,129,0.661649823,20
21195,453,386,85,85,0,67,0.947066978,31
21199,283,230,38,38,0,53,0.458248943,5
21203,26,20,4,4,0,6,0.502191782,2
21205,149,90,14,14,0,59,0.444244832,7
21207,25,25,2,2,0,0,0.323616445,2
21209,75,75,6,6,0,0,0.204054788,2
21211,70,30,4,4,0,40,0.096438356,2
21213,25,25,4,4,0,0,0.74936986,2
21217,90,90,8,8,0,0,0.285235912,3
21221,25,25,4,4,0,0,0.40120548,0
21225,25,25,4,4,0,0,0.462027401,2
21227,761,639,39,39,12,122,3.305994838,17
21231,25,25,4,4,0,0,0.342684925,1
21235,305,280,48,48,0,25,1.051795155,7
21239,25,25,4,4,0,0,0.255013704,1
22001,186,160,7,7,0,26,1.471843839,3
22003,109,74,7,7,0,35,0.330683812,2
22005,151,151,43,43,0,0,1.577970241,4
22007,15,15,3,3,0,0,0.020091325,1
22009,94,92,6,6,0,2,1.177266777,2
22011,80,80,6,6,4,0,1.231660604,2
22013,21,21,4,4,0,0,0.251924336,1
22015,278,217,19,19,0,61,2.550698638,10
22017,2130,1880,167,167,87,250,5.7169137,60
22019,947,744,91,91,43,203,3.325968236,19
22021,87,77,13,13,0,10,0.280283228,1
22023,49,49,9,9,0,0,,0
22027,47,37,4,4,0,10,0.366308779,2
22029,65,65,11,11,0,0,1.134575367,4
22031,34,34,6,6,0,0,0.112409346,1
22033,2297,1938,183,183,118,359,9.519840851,41
22035,23,23,4,4,0,0,0.140202507,0
22037,633,636,52,52,0,-3,0.895605635,0
22039,285,227,24,24,0,58,0.392988101,4
22041,37,29,6,6,0,8,0.236088812,2
22045,166,153,11,11,0,13,0.913317949,4
22047,10,10,0,0,0,0,0.684109569,0
22049,25,25,4,4,0,0,0.121863015,2
22051,2259,2003,209,209,111,256,7.469274614,42
22053,92,92,5,5,0,0,1.679540813,2
22055,1258,1266,176,176,159,-8,7.835078306,34
22057,240,178,21,21,0,62,1.058305204,12
22059,81,55,9,9,0,26,0.595214635,4
22061,266,236,26,26,11,30,2.574501276,4
22063,,,0,0,,0,,
22065,25,25,5,5,0,0,0.113972604,2
22067,119,109,6,6,0,10,1.788451001,2
22069,117,102,12,12,0,15,0.98003912,4
22071,2009,1319,269,269,139,690,6.180374697,37
22073,1033,818,111,111,60,215,4.676436514,29
22077,26,25,4,4,0,1,0.156054795,2
22079,1129,1110,75,75,55,19,6.697261125,32
22081,37,37,4,4,0,0,1.2900365,2
22083,63,63,6,6,0,0,0.39283058,2
22085,48,48,8,8,0,0,0.079623289,2
22087,40,40,8,8,0,0,0.38595891,2
22089,59,39,8,8,0,20,0.177520201,2
22091,25,25,4,4,0,0,0.17019178,0
22093,44,44,4,4,0,0,1.184294164,2
22095,82,82,0,0,0,0,0.522227168,0
22097,257,211,26,26,0,46,1.752885371,6
22099,43,43,4,4,0,0,1.402751923,2
22101,186,152,15,15,0,34,0.497442648,5
22103,1132,1070,256,256,28,62,5.490693823,22
22105,536,536,79,79,14,0,4.059502982,10
22109,567,344,38,38,8,223,2.175260603,13
22111,35,35,6,6,0,0,0.573196337,1
22113,95,69,10,10,0,26,0.643230379,5
22115,134,123,7,7,0,11,1.464318365,2
22117,117,61,13,13,0,56,0.548745826,4
22119,219,171,16,16,2,48,0.3522342,6
22123,30,30,5,5,0,0,0.549406409,0
22125,25,25,4,4,0,0,0.070027396,2
22127,60,46,5,5,0,14,0.143152669,2
23001,483,361,34,34,11,122,0.913107455,12
23003,228,160,24,24,0,68,2.078834921,9
23005,1121,985,56,56,31,136,3.755548686,24
23007,70,48,5,5,0,22,0.360347986,2
23009,114,98,14,14,0,16,1.286036551,5
23011,427,297,24,24,0,130,1.989282399,7
23013,99,81,8,8,0,18,0.555600762,3
23015,25,25,4,4,0,0,0.497837067,0
23017,75,50,8,8,0,25,0.872231215,4
23019,773,581,60,60,23,192,3.450202897,33
23021,48,50,8,8,0,-2,1.13326031,3
23025,50,50,8,8,0,0,0.900712341,4
23027,25,25,4,4,0,0,0.715897441,2
23029,50,50,8,8,0,0,0.709589034,4
23031,229,206,14,14,0,23,1.022459567,6
24001,279,288,14,14,0,-9,1.417474449,6
24003,634,483,50,50,30,151,1.471339941,24
24005,1965,1518,94,94,50,447,4.272766411,43
24009,73,41,4,4,0,32,0.746857345,5
24013,683,675,12,12,0,8,1.163792968,6
24015,175,182,5,5,0,-7,0.551170111,9
24017,99,98,10,10,0,1,0.717388868,7
24019,80,84,0,0,0,-4,0.927951753,0
24021,269,281,18,18,15,-12,0.718627214,16
24023,26,27,2,2,0,-1,0.59979707,2
24025,243,231,19,19,0,12,1.447180569,16
24027,225,245,48,48,0,-20,0.661392212,16
24029,12,21,6,6,0,-9,0.372994125,3
24031,2166,1682,231,231,85,484,5.642929733,80
24033,661,490,78,78,15,171,2.882595539,39
24037,93,96,12,12,0,-3,0.677340209,6
24041,97,48,16,16,0,49,0.612903774,9
24043,362,340,26,26,0,22,1.609773248,14
24045,391,418,34,34,0,-27,1.600130364,7
24047,40,32,6,6,0,8,0.597203195,3
24510,4158,3593,626,626,167,565,10.51810127,172
25001,430,410,22,22,0,20,3.041397512,14
25003,323,247,24,24,0,76,1.04750824,12
25005,1185,1101,110,110,16,84,6.721005797,52
25007,25,25,4,4,0,0,0.548712313,2
25009,1096,1274,107,107,0,-178,4.949893326,38
25011,89,89,6,6,0,0,0.56318301,3
25013,1537,1415,112,112,55,122,4.417164177,53
25015,140,118,11,11,0,22,0.540840507,3
25017,3502,3449,320,320,26,53,9.689480036,64
25019,14,19,3,3,0,-5,0.264167279,1
25021,1527,1327,114,114,0,200,7.049222738,32
25023,700,659,48,48,0,41,2.927898049,25
25025,6229,5704,903,903,120,525,13.79839787,127
25027,2203,2457,212,212,27,-254,8.423274606,70
26003,11,11,2,2,0,0,0.112079702,0
26005,68,68,11,11,0,0,0.474278435,3
26007,124,128,9,9,0,-4,0.325727731,3
26011,25,25,5,5,0,0,0.16526027,2
26013,15,15,3,3,0,0,0.19075343,1
26015,25,25,6,6,0,0,0.523185849,2
26017,387,322,37,37,0,65,1.031513125,10
26019,8,8,1,1,0,0,0.009931507,0
26021,259,222,25,25,0,37,0.51676327,15
26023,71,87,10,10,0,-16,0.359313488,3
26025,281,262,37,37,0,19,1.654590636,11
26027,25,25,4,4,0,0,0.100273974,2
26029,25,25,4,4,0,0,0.24745205,2
26033,82,49,6,6,0,33,0.504892349,3
26035,49,49,9,9,0,0,0.148224771,2
26037,66,66,2,2,0,0,1.064090878,2
26039,71,49,6,6,0,22,0.368856579,2
26041,25,25,9,9,0,0,0.387506843,2
26043,66,56,6,6,0,10,0.515279233,2
26045,45,45,7,7,0,0,0.423506841,4
26047,202,170,18,18,0,32,0.531813025,6
26049,1151,1051,125,125,44,100,2.827677667,43
26051,25,25,4,4,0,0,0.12328767,2
26053,25,25,5,5,0,0,0.359232873,2
26055,425,409,20,20,0,16,0.591452599,8
26057,67,49,9,9,0,18,0.557897687,2
26059,65,44,4,4,0,21,0.276587784,2
26061,61,61,11,11,0,0,0.600088269,4
26063,98,73,11,11,0,25,0.56467247,3
26065,913,873,120,120,33,40,1.853980482,22
26067,22,25,2,2,0,-3,0.287546694,2
26069,47,47,4,4,0,0,0.199242204,2
26071,25,25,3,3,0,0,0.248876706,2
26073,118,90,8,8,0,28,0.225905627,3
26075,501,469,61,61,0,32,1.176374733,10
26077,989,904,70,70,53,85,1.990608037,21
26079,8,8,1,1,0,0,0.181332231,1
26081,1796,2018,157,157,111,-222,5.160885453,40
26087,183,116,10,10,0,67,0.527657092,4
26091,113,113,13,13,0,0,0.341290146,5
26093,107,142,25,25,0,-35,1.004239917,3
26095,25,25,4,4,0,0,0.192219183,1
26097,15,15,3,3,0,0,0.393789947,0
26099,1229,1254,139,139,0,-25,4.606128898,47
26101,45,45,8,8,0,0,0.200913236,2
26103,204,263,30,30,11,-59,0.654069796,6
26105,45,45,6,6,0,0,0.398965001,2
26107,49,49,4,4,0,0,0.345932335,2
26111,308,324,26,26,0,-16,0.495907336,7
26115,217,153,14,14,0,64,0.35286954,4
26117,148,131,18,18,0,17,0.855237402,4
26121,227,362,49,49,0,-135,1.136491001,8
26123,25,25,9,9,0,0,0.443945199,2
26125,4386,3797,390,390,44,589,7.982104391,114
26127,24,24,4,4,0,0,0.106963471,0
26129,88,88,15,15,0,0,0.237589717,2
26131,25,25,4,4,0,0,0.055123288,2
26133,25,25,4,4,0,0,0.16843836,2
26137,46,46,4,4,0,0,0.355926156,2
26139,309,325,22,22,0,-16,0.835234359,6
26145,610,724,106,106,0,-114,2.542347014,23
26147,375,372,23,23,0,3,1.000835039,10
26149,144,97,13,13,0,47,0.320313811,4
26151,65,65,11,11,0,0,0.41395434,3
26153,12,12,2,2,0,0,0.387899548,2
26155,107,111,7,7,0,-4,0.401678383,3
26157,168,168,8,8,0,0,1.081263959,2
26159,74,74,14,14,0,0,0.222002789,4
26161,1971,1778,89,89,0,193,3.841527432,60
26163,6217,5357,676,676,190,860,14.91560727,209
26165,49,49,20,20,0,0,0.489628166,3
27001,25,25,4,4,0,0,0.375561655,2
27003,746,666,35,35,0,80,1.489001453,7
27005,87,36,8,8,0,51,0.4434551,2
27007,134,105,10,10,0,29,1.408569336,3
27011,40,40,7,7,0,0,0.218045667,2
27013,272,167,29,29,0,105,0.617553949,9
27015,78,40,7,7,0,38,0.639840186,3
27017,105,47,6,6,0,58,0.602361143,2
27019,109,109,18,18,0,0,0.504378676,3
27021,5,5,1,1,0,0,0.00109589,0
27023,30,25,4,4,0,5,0.228602737,2
27025,61,55,10,10,0,6,0.446475714,2
27029,48,48,8,8,0,0,0.126823105,0
27031,16,16,3,3,0,0,0.207363009,0
27033,26,26,4,4,0,0,0.292846277,0
27035,220,168,16,16,0,52,1.785742968,5
27037,244,216,23,23,0,28,1.325591058,6
27041,143,115,8,8,0,28,1.226669103,3
27043,43,24,4,4,0,19,0.355593622,1
27047,159,159,18,18,0,0,0.251624018,4
27049,83,83,12,12,0,0,1.229796052,6
27051,10,10,2,2,0,0,0.135890409,0
27053,7211,3717,445,445,385,3494,5.962278718,82
27057,50,25,4,4,0,25,0.457205474,2
27059,86,70,12,12,0,16,0.377729952,2
27061,104,76,12,12,0,28,0.643789947,5
27063,20,14,2,2,0,6,0.174168304,0
27065,49,25,4,4,0,24,0.336328775,2
27067,136,81,40,40,0,55,0.414375097,3
27069,15,15,3,3,0,0,0.081643835,0
27071,25,18,3,3,0,7,0.368217051,0
27073,32,32,5,5,0,0,0.464200914,0
27075,25,16,3,3,0,9,0.413527399,1
27077,15,15,3,3,0,0,0.206575349,0
27079,15,9,2,2,0,6,0.200000003,0
27081,44,44,7,7,0,0,0.155039139,1
27083,74,50,8,8,0,24,0.465753417,2
27085,115,74,10,10,0,41,0.778086662,3
27087,18,10,2,2,0,8,0.145205483,0
27089,12,12,2,2,0,0,0.222146124,1
27091,57,55,10,10,0,2,0.217235371,2
27093,35,25,4,4,0,10,0.280876726,0
27095,28,28,5,5,0,0,0.237964779,0
27097,49,25,4,4,0,24,0.342794508,2
27101,25,20,3,3,0,5,0.168356165,2
27103,73,65,3,3,0,8,0.47574538,0
27105,48,48,8,8,0,0,0.144121006,2
27107,14,14,2,2,0,0,0.049119372,1
27109,2136,1192,250,250,0,944,1.746156171,62
27111,149,121,9,9,0,28,1.284938365,3
27113,42,41,4,4,0,1,1.056890398,2
27115,30,9,2,2,0,21,0.260578394,1
27117,44,18,3,3,0,26,0.160121769,1
27119,92,54,9,9,0,38,0.397009134,2
27121,34,19,3,3,0,15,0.406056225,1
27123,1925,1328,151,151,10,597,4.680722296,31
27127,25,25,4,4,0,0,0.190718234,1
27129,16,16,3,3,0,0,0.262842476,1
27131,49,32,6,6,0,17,0.323030829,2
27133,28,25,4,4,0,3,0.232219175,2
27135,25,25,4,4,0,0,0.252493143,2
27137,1121,815,97,97,18,306,3.179091662,31
27139,142,109,19,19,0,33,1.04706341,4
27141,54,33,4,4,0,21,0.375923634,2
27143,20,16,3,3,0,4,0.150171235,0
27145,590,535,52,52,30,55,1.642976522,25
27147,43,29,5,5,0,14,0.502031147,2
27149,49,25,4,4,0,24,0.276164383,0
27151,36,33,6,6,0,3,0.341156773,0
27153,71,39,5,5,0,32,0.969001949,2
27155,25,15,3,3,0,10,0.099908672,0
27157,25,14,2,2,0,11,0.257729948,1
27159,124,100,15,15,0,24,0.261698633,1
27161,35,15,3,3,0,20,0.456438363,1
27163,183,154,31,31,0,29,1.023187399,4
27165,50,50,8,8,0,0,0.373150676,1
27167,25,25,4,4,0,0,0.276821911,1
27169,49,49,8,8,0,0,0.468225867,2
27171,106,85,11,11,0,21,1.697582215,4
27173,55,47,8,8,0,8,0.368478209,0
28001,159,147,15,15,0,12,0.294529855,3
28003,200,163,24,24,0,37,0.461736292,4
28005,25,16,3,3,0,9,0.564897239,2
28007,25,25,4,4,0,0,0.364712328,2
28011,164,152,8,8,0,12,0.193024516,2
28013,25,25,4,4,0,0,0.541808248,0
28017,84,39,7,7,0,45,0.130663857,1
28019,25,15,3,3,0,10,0.459726036,2
28021,32,22,4,4,0,10,0.362764627,0
28023,25,25,4,4,0,0,0.433424652,0
28025,49,49,6,6,0,0,0.424937099,2
28027,181,181,10,10,0,0,0.148878559,2
28029,25,25,4,4,0,0,0.604054809,1
28031,35,25,4,4,0,10,0.561972618,0
28033,514,460,62,62,1,54,1.767497748,9
28035,542,459,45,45,0,83,0.700569391,21
28037,25,24,4,4,0,1,0.671347022,1
28039,48,42,6,6,0,6,0.200848013,2
28041,7,7,1,1,0,0,0.538943231,1
28043,156,49,9,9,0,107,0.368409276,2
28045,102,51,6,6,0,51,0.171044856,2
28047,1081,832,66,66,23,249,3.247316539,18
28049,2391,2049,195,195,199,342,4.236744761,63
28051,25,25,4,4,0,0,0.285808206,0
28059,435,435,48,48,0,0,0.564258277,27
28061,16,16,3,3,0,0,0.319589049,0
28063,30,12,2,2,0,18,0.071689501,0
28065,35,25,4,4,0,10,0.138630137,0
28067,285,268,14,14,0,17,0.34755674,5
28069,25,25,4,4,0,0,0.40438357,0
28071,217,171,24,24,0,46,0.553120255,5
28073,261,175,17,17,0,86,1.477787137,4
28075,988,767,74,74,6,221,2.801273555,19
28077,25,25,4,4,0,0,0.29939726,0
28079,25,25,4,4,0,0,0.658849299,1
28081,700,586,42,42,26,114,1.488180995,30
28083,208,173,9,9,0,35,0.301005632,5
28085,99,90,5,5,0,9,0.17923896,4
28087,315,159,18,18,0,156,0.423523098,4
28089,67,67,7,7,0,0,0.175833166,2
28091,49,49,6,6,0,0,0.351132244,2
28093,40,27,5,5,0,13,0.203348547,0
28095,130,119,13,13,6,11,0.815158367,3
28097,25,25,4,4,0,0,0.450630128,2
28099,68,58,11,11,0,10,0.413684197,1
28101,25,25,4,4,0,0,0.584986329,1
28103,25,25,4,4,0,0,0.34147945,0
28105,96,88,6,6,0,8,0.21960406,2
28107,112,45,8,8,0,67,0.576271176,2
28109,84,73,10,10,0,11,0.824047148,3
28111,22,22,4,4,0,0,0.187297627,0
28113,191,177,19,19,0,14,0.442398265,6
28115,25,25,4,4,0,0,0.594958901,0
28117,114,39,7,7,0,75,0.184334382,2
28121,2055,608,44,44,36,1447,2.661657155,5
28123,35,25,4,4,0,10,0.451835603,0
28125,29,19,3,3,0,10,0.238573402,0
28127,99,69,12,12,0,30,0.611479461,0
28129,29,19,3,3,0,10,0.000720981,0
28131,25,25,4,4,0,0,0.540931523,2
28133,138,126,12,12,0,12,0.939987153,4
28135,18,9,2,2,0,9,1,0
28139,25,25,4,4,0,0,0.42487672,1
28141,48,66,8,8,0,-18,0.230136991,2
28145,153,92,8,8,0,61,0.245622396,2
28147,25,25,4,4,0,0,0.159013703,1
28149,396,336,27,27,0,60,0.919186294,7
28151,266,216,28,28,0,50,0.968762815,7
28153,80,49,6,6,0,31,0.450768799,2
28155,38,38,7,7,0,0,0.536697924,0
28159,41,14,2,2,0,27,0.239921719,1
28161,26,26,5,5,0,0,0.631085336,1
28163,25,25,4,4,0,0,0.465095878,2
29001,93,51,10,10,0,42,0.458930969,2
29005,18,16,3,3,0,2,0.341952056,1
29007,70,40,7,7,0,30,0.28938356,2
29009,43,43,7,7,0,0,0.457936063,3
29011,25,25,4,4,0,0,0.25698629,1
29013,60,44,8,8,0,16,0.207160652,2
29019,1184,1199,150,150,97,-15,2.064027816,32
29021,501,501,27,27,0,0,1.967721581,10
29023,240,220,14,14,0,20,0.559713602,8
29027,75,56,3,3,0,19,0.995449807,1
29029,130,114,18,18,0,16,1.139561623,4
29031,580,494,51,51,36,86,1.644923627,20
29033,25,21,4,4,0,4,0.220743641,0
29037,106,96,9,9,0,10,0.724879056,3
29039,41,41,16,16,0,0,1.099835634,1
29047,769,709,43,43,0,60,2.793918699,15
29049,58,42,5,5,0,16,0.420287013,2
29051,268,254,25,25,0,14,0.891889095,6
29055,35,25,4,4,0,10,0.523397267,2
29065,55,25,4,4,0,30,0.395287663,1
29071,148,148,13,13,0,0,0.377434283,4
29073,24,24,4,4,0,0,0.408105016,1
29075,35,25,4,4,0,10,0.228821918,0
29077,1748,1497,203,203,80,251,3.547622085,30
29079,22,21,4,4,0,1,0.369863003,1
29081,19,14,4,4,0,5,0.455968678,2
29083,110,96,8,8,0,14,1.150434911,2
29091,139,128,16,16,0,11,0.605135791,4
29093,15,15,4,4,0,0,0.266301364,2
29095,2959,2319,280,280,176,640,7.676522523,55
29097,25,25,4,4,0,0,0.55463016,1
29099,321,279,28,28,0,42,0.402602255,5
29101,62,46,8,8,0,16,0.42969355,2
29105,58,43,4,4,0,15,0.356164396,2
29107,32,25,2,2,0,7,0.281534255,2
29109,53,25,4,4,0,28,0.196383566,2
29113,25,25,4,4,0,0,0.351890415,2
29115,25,25,4,4,0,0,0.123506851,1
29117,25,25,4,4,0,0,0.587397277,2
29121,25,25,4,4,0,0,0.437150687,0
29123,144,25,4,4,0,119,0.237479448,0
29127,99,86,8,8,0,13,0.484326214,4
29145,658,634,96,96,38,24,2.191877484,31
29147,81,38,7,7,0,43,0.180451125,2
29155,167,49,7,7,0,118,0.349398941,2
29157,25,25,4,4,0,0,0.625205457,1
29159,99,108,9,9,0,-9,0.373963207,3
29161,242,172,18,18,0,70,0.28324306,3
29163,25,25,4,4,0,0,0.175232872,2
29165,97,118,12,12,0,-21,0.628562033,2
29167,86,52,8,8,0,34,0.446838766,3
29169,46,46,0,0,,0,,0
29171,15,15,3,3,0,0,0.285114169,0
29175,99,33,8,8,0,66,0.26162231,2
29177,34,25,4,4,0,9,0.33687672,2
29183,874,880,62,62,0,-6,3.571622014,24
29185,12,12,2,2,0,0,0.063123286,0
29186,47,25,4,4,0,22,0.417863011,2
29187,471,433,11,11,0,38,1.237860629,6
29189,4846,4371,498,498,244,475,9.267881319,105
29195,60,42,7,7,0,18,0.270711035,2
29199,25,25,4,4,0,0,0.344876707,2
29201,125,87,12,12,0,38,0.351913095,3
29207,48,48,4,4,0,0,0.283390403,2
29211,25,16,3,3,0,9,0.590753436,0
29213,157,111,18,18,0,46,0.665852129,4
29215,66,47,4,4,0,19,0.268551439,3
29217,140,41,6,6,0,99,0.173471436,2
29221,25,25,4,4,0,0,0.438575357,2
29510,2297,2694,321,321,125,-397,5.696093351,68
30001,18,18,3,3,0,0,0.3392694,1
30003,49,49,8,8,0,0,0.301936068,0
30005,6,6,1,1,0,0,0.011415525,0
30007,25,25,4,4,0,0,0.82608217,0
30009,10,10,2,2,0,0,0.559452057,1
30011,25,25,4,4,0,0,0.632767141,0
30013,549,332,24,24,24,217,0.881570101,7
30015,50,33,5,5,0,17,0.831780851,0
30017,25,25,4,4,0,0,0.560547948,2
30019,25,25,4,4,0,0,0.831232905,0
30021,25,25,3,3,0,0,0.303232878,2
30023,199,199,4,4,0,0,1.554301381,2
30025,25,25,4,4,0,0,0.596931517,0
30027,25,23,4,4,0,2,0.398213208,1
30029,247,220,25,25,9,27,1.329722658,10
30031,90,87,9,9,0,3,0.676427457,4
30033,25,4,1,1,0,21,0.006164384,0
30035,46,46,8,8,0,0,0.289462596,1
30039,25,25,4,4,0,0,0.840109587,0
30041,49,49,6,6,0,0,0.166172773,2
30047,47,47,9,9,0,0,0.732323766,3
30049,153,131,9,9,2,22,1.444223464,5
30051,25,25,4,4,0,0,0.845589042,0
30053,25,25,4,4,0,0,0.271671236,2
30055,25,25,4,4,0,0,0.537899554,0
30057,15,20,4,4,0,-5,0.555068493,0
30059,25,25,4,4,0,0,0.693808198,0
30061,25,24,4,4,0,1,0.655936062,0
30063,404,299,32,32,24,105,1.060266227,9
30065,25,25,4,4,0,0,0.843287647,0
30067,25,25,4,4,0,0,0.432547957,2
30071,6,6,1,1,0,0,0.247945204,1
30073,20,20,3,3,0,0,0.137123287,2
30077,16,16,3,3,0,0,0.196404114,0
30079,22,22,4,4,0,0,0.94520545,0
30081,25,25,5,5,0,0,0.567780793,2
30083,25,25,4,4,0,0,0.506630123,2
30085,67,75,13,13,0,-8,1.040132836,1
30087,25,25,1,1,0,0,0.342246562,0
30089,16,16,3,3,0,0,0.31369862,2
30091,19,19,3,3,0,0,0.223792359,1
30093,98,71,11,11,0,27,0.55145669,2
30095,10,10,2,2,0,0,0.358356178,0
30097,25,25,4,4,0,0,0.821260273,0
30099,25,25,4,4,0,0,0.901808202,0
30101,21,21,4,4,0,0,0.155381605,1
30105,25,25,4,4,0,0,0.171397254,0
30107,25,25,4,4,0,0,0.774575353,0
30111,664,577,53,53,48,87,2.088667512,16
31001,200,127,10,10,0,73,1.385228068,3
31003,23,23,4,4,0,0,0.115783207,0
31011,25,25,4,4,0,0,0.349479467,2
31013,25,25,4,4,0,0,0.333150685,2
31015,15,15,3,3,0,0,0.050320514,0
31017,23,23,4,4,0,0,0.136748061,0
31019,361,362,34,34,18,-1,0.805941522,7
31021,16,16,3,3,0,0,0.050171234,0
31023,20,20,3,3,0,0,0.207123294,0
31029,20,22,4,4,0,-2,0.075479455,0
31031,19,25,4,4,0,-6,0.171616435,1
31033,25,19,4,4,0,6,0.282624364,2
31037,25,25,4,4,0,0,0.040219177,0
31039,25,25,4,4,0,0,0.20449315,1
31041,35,35,6,6,0,0,0.217153072,1
31045,25,25,4,4,0,0,0.179835618,1
31047,57,57,9,9,0,0,0.633945197,2
31053,75,50,9,9,0,25,0.405917794,3
31055,2630,2214,317,317,129,416,6.964584351,63
31057,14,14,2,2,0,0,0.124853231,1
31059,20,20,3,3,0,0,0.211780816,0
31061,14,14,2,2,0,0,0.045401175,0
31065,20,20,3,3,0,0,0.264109582,1
31067,25,25,3,3,0,0,0.436054796,2
31069,10,10,2,2,0,0,0.07342466,0
31079,157,140,16,16,9,17,0.406086117,5
31081,12,14,2,2,0,-2,0.270645797,1
31083,19,19,3,3,0,0,0.112472966,0
31089,42,42,7,7,0,0,0.501885578,2
31093,10,16,3,3,0,-6,0.151027396,0
31095,17,17,3,3,0,0,0.139242545,0
31097,18,18,3,3,0,0,0.196194828,1
31099,10,10,2,2,0,0,0.203561649,0
31101,18,18,3,3,0,0,0.119786911,2
31105,15,15,3,3,0,0,0.227031961,0
31107,23,23,4,4,0,0,0.119356759,0
31109,1062,1128,103,103,57,-66,4.429097116,32
31111,116,97,19,19,0,19,0.502022684,6
31119,131,131,24,24,0,0,0.385577977,5
31121,20,20,3,3,0,0,0.163835615,1
31123,20,20,3,3,0,0,0.102054797,1
31125,19,19,3,3,0,0,0.083056957,0
31127,16,16,3,3,0,0,0.128424659,0
31129,25,25,4,4,0,0,0.183780819,1
31131,28,28,5,5,0,0,0.266289093,2
31133,11,17,3,3,0,-6,0.119419821,0
31135,20,20,3,3,0,0,0.233013704,0
31137,25,25,4,4,0,0,0.385534257,2
31139,35,35,6,6,0,0,0.374657542,1
31141,47,47,5,5,0,0,0.346079856,2
31143,16,16,3,3,0,0,0.067636989,0
31145,25,25,4,4,0,0,0.374465764,2
31147,24,24,4,4,0,0,0.286073059,1
31149,24,24,4,4,0,0,0.089954339,0
31151,43,43,7,7,0,0,0.19572819,0
31153,212,89,13,13,3,123,0.819886491,5
31155,16,16,3,3,0,0,0.131335616,2
31157,166,122,22,22,0,44,0.44864136,4
31159,24,24,4,4,0,0,0.348515987,0
31161,25,25,4,4,0,0,0.161424652,0
31169,17,19,3,3,0,-2,0.18731074,1
31173,34,34,6,6,0,0,0.406824216,1
31175,16,16,3,3,0,0,0.327397257,0
31177,21,21,4,4,0,0,0.086757988,2
31179,21,25,4,4,0,-4,0.194781467,0
31181,13,13,2,2,0,0,0.081348792,0
31185,38,38,6,6,0,0,0.424800843,0
32001,40,25,4,4,0,15,0.496767133,2
32003,6897,5775,652,652,311,1122,20.19113511,230
32005,23,23,4,4,0,0,0.504586041,2
32007,75,59,7,7,0,16,0.199257016,2
32013,53,25,3,3,0,28,0.306082189,1
32015,25,5,2,2,0,20,0.222465754,2
32017,20,4,1,1,0,16,0.725342453,0
32019,63,14,2,2,0,49,0.16438356,0
32021,35,11,2,2,0,24,0.59078455,1
32023,25,25,4,4,0,0,0.388054788,2
32027,38,13,2,2,0,25,0.104741834,1
32031,1783,1390,302,302,68,393,3.895843023,34
32033,25,25,4,4,0,0,0.184,2
32510,255,219,32,32,0,36,1.526631266,9
33001,137,86,10,10,0,51,0.60156101,3
33003,50,50,8,8,0,0,0.857863009,4
33005,169,86,27,27,0,83,0.584931493,4
33007,66,66,10,10,0,0,0.985986292,5
33009,506,500,64,64,30,6,2.812758774,24
33011,1082,824,66,66,0,258,2.770143718,22
33013,563,474,29,29,0,89,3.478530914,14
33015,617,506,43,43,0,111,3.399772733,13
33017,290,182,17,17,0,108,1.166235924,9
33019,25,25,4,4,0,0,0.401863009,2
34001,557,821,65,65,22,-264,2.790551305,36
34003,2874,1934,122,122,56,940,5.233403444,80
34005,894,795,100,100,0,99,4.550041258,29
34007,2231,2407,166,166,94,-176,4.255861819,92
34009,242,149,16,16,0,93,0.432950258,6
34011,365,321,24,24,0,44,1.586988688,16
34013,3541,2515,226,226,169,1026,7.207115352,84
34015,311,233,46,46,0,78,0.437850535,8
34017,1764,1086,89,89,41,678,3.992099345,28
34019,184,170,12,12,0,14,0.568511546,9
34021,1608,1199,83,83,0,409,4.432063013,23
34023,2527,2112,232,232,104,415,5.18103385,83
34025,2155,1643,128,128,75,512,3.855546594,59
34027,1782,1566,111,111,38,216,3.247209519,52
34029,1528,1325,114,114,0,203,5.249503642,47
34031,920,823,53,53,56,97,1.302724361,31
34033,222,209,19,19,0,13,0.565235317,7
34035,944,820,45,45,0,124,2.3651582,11
34037,148,130,10,10,0,18,0.713930428,6
34039,1332,951,77,77,15,381,3.538879335,31
34041,309,156,20,20,0,153,1.081502438,7
35001,1981,1937,179,179,163,44,7.665148467,50
35005,232,204,24,24,0,28,1.136728227,5
35006,31,31,5,5,0,0,0.297242012,1
35007,25,25,4,4,0,0,0.240767121,1
35009,100,106,8,8,0,-6,0.28314811,3
35013,618,663,60,60,12,-45,4.078846931,15
35015,148,116,18,18,0,32,0.395548448,4
35017,68,32,6,6,0,36,0.333219171,2
35019,10,10,2,2,0,0,0.159999996,0
35025,86,86,12,12,0,0,0.309207276,4
35027,25,25,4,4,0,0,0.400547951,2
35028,47,47,6,6,0,0,0.131506845,2
35029,25,25,6,6,0,0,0.463890404,2
35031,191,148,26,26,0,43,1.504191309,3
35035,106,56,11,11,0,50,0.606027417,2
35037,25,25,4,4,0,0,0.093150683,2
35039,70,52,8,8,0,18,0.406150401,2
35041,24,20,4,4,0,4,0.129589036,2
35043,60,60,11,11,0,0,0.545707762,3
35045,270,260,21,21,0,10,1.171688795,10
35047,175,226,8,8,0,-51,0.211256698,2
35049,240,225,25,25,0,15,1.101476103,6
35051,25,11,2,2,0,14,0.369364887,2
35053,24,24,4,4,0,0,0.169063926,2
35055,25,6,6,6,0,19,0.494904101,2
35059,25,25,4,4,0,0,0.085808218,1
36001,1532,1479,116,116,75,53,2.746104002,41
36003,55,69,9,9,0,-14,0.67739439,2
36005,2816,3345,274,274,162,-529,6.268887483,85
36007,573,492,47,47,14,81,2.008267999,16
36009,186,260,46,46,0,-74,0.421495438,3
36011,99,85,15,15,0,14,0.554423869,2
36013,356,208,27,27,0,148,0.952826351,6
36015,471,325,24,24,18,146,2.119283497,8
36017,58,58,7,7,0,0,0.17264998,2
36019,300,300,21,21,0,0,0.438885838,11
36021,192,95,9,9,0,97,0.659120381,5
36023,162,103,12,12,0,59,0.305315673,2
36025,63,56,10,10,0,7,1.056029677,2
36027,942,874,59,59,15,68,1.894836903,13
36029,2573,2265,307,307,129,308,5.899902433,46
36031,25,25,4,4,0,0,0.43265754,1
36033,171,126,13,13,0,45,0.587596387,4
36035,74,58,8,8,0,16,0.363344342,3
36037,111,131,10,10,0,-20,0.373364925,2
36043,25,25,4,4,0,0,0.610849321,2
36045,330,287,18,18,12,43,1.406005099,5
36047,5838,4320,282,282,216,1518,10.37918854,160
36049,31,25,6,6,0,6,0.465315074,2
36051,67,67,12,12,0,0,0.307708025,2
36053,126,126,10,10,0,0,0.795477539,4
36055,2331,2038,247,247,100,293,4.584553003,34
36057,120,100,8,8,0,20,0.62071234,5
36059,4758,3598,334,334,237,1160,7.013464868,173
36061,8650,7479,944,944,460,1171,14.02870199,211
36063,482,443,32,32,0,39,1.462334365,7
36065,988,774,37,37,0,214,2.193227351,15
36067,1490,1736,145,145,86,-246,2.861240327,38
36069,384,307,27,27,0,77,1.343779266,8
36071,1112,985,76,76,20,127,3.13866353,29
36073,39,25,4,4,0,14,0.302027404,2
36075,132,132,8,8,0,0,0.266687423,3
36077,233,227,26,26,0,6,1.093618751,7
36079,164,120,10,10,0,44,0.379365087,3
36081,3210,2663,146,146,92,547,5.440034866,65
36083,292,257,30,30,0,35,1.44087261,8
36085,1177,1060,72,72,40,117,2.453834593,51
36087,1301,1144,50,50,20,157,2.130560756,14
36089,387,384,27,27,0,3,3.10177207,8
36091,259,259,30,30,0,0,1.799147546,5
36093,483,351,39,39,0,132,1.331567466,7
36095,25,40,7,7,0,-15,0.270993024,2
36097,25,25,4,4,0,0,0.396493137,2
36101,115,95,14,14,0,20,1.238552883,7
36103,3878,3505,298,298,109,373,10.66566002,132
36105,169,99,18,18,0,70,0.699863017,5
36109,212,163,16,16,0,49,0.438330352,5
36111,325,209,28,28,0,116,1.80815056,5
36113,391,361,24,24,0,30,0.367593825,4
36117,120,101,8,8,0,19,0.499471039,2
36119,3014,2427,233,233,109,587,8.388927281,69
36121,62,50,5,5,0,12,0.308219165,2
36123,35,25,4,4,0,10,0.233095884,2
37001,238,176,20,20,12,62,0.573707998,7
37005,41,25,4,4,0,16,0.089643836,2
37007,15,15,3,3,0,0,0.1369863,2
37009,76,25,4,4,0,51,0.467068493,2
37011,50,21,4,4,0,29,0.218917161,2
37013,142,72,8,8,0,70,0.504033506,3
37015,6,6,1,1,0,0,0.663926959,2
37017,58,25,4,4,0,33,0.343671232,2
37019,139,126,23,23,0,13,1.714631662,4
37021,1009,863,151,151,51,146,3.064156353,31
37023,746,587,16,16,4,159,1.083847612,3
37025,457,447,15,15,25,10,0.645686626,14
37027,110,110,12,12,0,0,0.487247825,3
37031,135,99,8,8,0,36,0.660689056,5
37035,613,426,52,52,6,187,0.781329006,15
37037,25,25,4,4,0,0,0.490739733,2
37039,57,25,5,5,0,32,0.658410966,2
37041,49,25,4,4,0,24,0.562630117,2
37045,375,292,57,57,0,83,0.767030954,10
37047,154,154,27,27,0,0,0.322309196,2
37049,350,287,72,72,0,63,0.621201873,12
37051,838,694,56,56,44,144,1.66676569,22
37055,21,21,4,4,0,0,0.318199605,2
37057,240,154,29,29,0,86,0.8575176,4
37059,50,50,9,9,,0,,1
37061,81,49,9,9,0,32,0.556108475,3
37063,1446,1358,174,174,135,88,2.796210259,35
37065,117,101,15,15,0,16,0.356300026,4
37067,2134,1990,205,205,100,144,3.242227077,38
37071,435,383,57,57,0,52,0.734847426,12
37077,1442,1342,164,164,0,100,1.820425898,2
37081,1388,955,124,124,36,433,2.596161991,39
37083,204,106,16,16,0,98,0.480175763,3
37085,248,243,32,32,0,5,1.210285664,4
37087,154,122,12,12,0,32,0.376869529,3
37089,325,233,27,27,0,92,1.024856478,6
37091,114,70,10,10,0,44,0.502035201,3
37093,49,61,11,11,0,-12,0.27357167,2
37097,514,410,36,36,0,104,1.154252142,14
37099,86,82,9,9,0,4,0.407517552,3
37101,199,179,24,24,0,20,0.522537708,7
37105,137,127,8,8,1,10,0.306331575,5
37107,261,1086,190,190,0,-825,0.448511422,10
37109,101,101,10,10,0,0,0.511433601,4
37111,65,49,9,9,0,16,0.437365204,3
37113,83,49,9,9,0,34,1.048414618,3
37117,49,43,6,6,0,6,0.252819359,2
37119,2662,2388,188,188,164,274,6.981805027,66
37121,46,25,4,4,0,21,0.522926807,2
37123,37,3,2,2,0,34,0.636529684,2
37125,402,412,56,56,13,-10,0.672336757,14
37127,395,372,29,29,9,23,1.260454029,11
37129,861,769,45,45,51,92,1.277158618,16
37133,306,306,14,14,0,0,1.281494796,9
37135,1006,886,47,47,20,120,0.842581511,16
37139,182,91,10,10,0,91,0.588830352,4
37141,86,25,4,4,0,61,0.458739728,1
37145,98,38,6,6,0,60,0.244556591,2
37147,1088,961,83,83,12,127,1.877041578,40
37149,35,25,6,6,0,10,0.510575354,2
37151,145,145,12,12,0,0,0.250033051,4
37155,452,246,25,25,0,206,0.601035774,11
37157,229,108,9,9,0,121,0.254109591,3
37159,268,169,21,21,0,99,0.69676584,5
37161,143,111,18,18,0,32,0.249216333,2
37163,146,59,8,8,0,87,0.403389841,2
37165,104,97,8,8,0,7,0.551729977,3
37167,109,97,10,10,0,12,0.320717424,4
37169,99,25,4,4,0,74,0.200547948,1
37171,226,181,24,24,0,45,0.787882626,4
37173,68,44,8,8,0,24,0.65518266,1
37175,92,25,4,4,0,67,0.583414614,2
37179,182,182,14,14,4,0,0.506894469,8
37181,184,91,20,20,0,93,0.517025411,6
37183,2376,2096,177,177,80,280,4.988952845,49
37187,49,33,4,4,0,16,0.056965519,1
37189,117,95,10,10,4,22,0.407498211,2
37191,569,514,16,16,0,55,1.402839601,6
37193,130,93,8,8,0,37,0.330387384,4
37195,294,270,14,14,0,24,0.257087767,9
38001,25,25,4,4,0,0,0.270684928,2
38003,25,25,4,4,0,0,0.32273972,2
38009,25,25,4,4,0,0,0.604712307,0
38011,23,23,4,4,0,0,0.134842172,0
38015,510,386,52,52,0,124,1.109883547,9
38017,1254,1352,280,280,0,-98,3.052256882,27
38019,20,20,3,3,0,0,0.062602736,1
38021,20,20,3,3,0,0,0.220273972,1
38023,15,15,3,3,0,0,0.263196349,0
38029,14,14,2,2,0,0,0.103326812,0
38031,25,25,4,4,0,0,0.133041099,0
38035,419,384,36,36,0,35,1.431535125,6
38037,25,30,5,5,0,-5,0.83132422,0
38039,18,18,3,3,0,0,0.114764079,1
38051,44,44,7,7,0,0,0.247328766,0
38053,24,24,4,4,0,0,0.103082195,0
38055,47,47,8,8,0,0,1.241300166,0
38057,13,13,2,2,0,0,0.302423596,0
38059,41,41,6,6,0,0,0.448780477,2
38061,11,11,2,2,0,0,0.148941472,0
38063,19,19,3,3,0,0,0.141600579,0
38067,20,20,3,3,0,0,0.107260272,0
38069,25,25,4,4,0,0,0.294137001,0
38071,25,25,4,4,0,0,0.346520543,2
38073,25,25,4,4,0,0,0.388164371,1
38079,52,52,9,9,0,0,0.498203948,0
38085,12,12,2,2,0,0,0.042237442,0
38089,25,25,4,4,0,0,0.494246572,2
38093,165,133,6,6,0,32,1.105787933,2
38095,20,20,3,3,0,0,0.158630133,0
38097,41,41,7,7,0,0,0.407801375,1
38099,28,28,4,4,0,0,0.787084132,1
38101,190,190,23,23,16,0,1.216979086,4
38103,25,25,4,4,0,0,0.214465752,0
38105,50,50,8,8,0,0,0.599561632,2
39001,25,25,4,4,0,0,0.543013692,1
39003,816,469,44,44,0,347,2.30961404,15
39005,123,39,6,6,0,84,0.528767109,4
39007,431,286,39,39,0,145,2.711043462,7
39009,156,156,11,11,0,0,1.083747767,3
39011,131,36,6,6,0,95,0.387442917,2
39013,165,165,13,13,0,0,0.789348572,6
39017,790,631,56,56,0,159,3.043317616,17
39021,25,25,4,4,0,0,0.323835611,2
39023,270,270,42,42,0,0,1.597108439,4
39025,160,147,16,16,0,13,0.523591876,4
39027,179,89,8,8,0,90,0.350136995,3
39029,331,219,20,20,0,112,0.823405743,7
39031,56,56,7,7,0,0,0.315606654,3
39033,75,50,9,9,0,25,0.796602756,4
39035,7053,5395,794,794,206,1658,12.01491079,143
39037,104,40,6,6,0,64,0.273561656,3
39039,104,73,16,16,0,31,0.880614638,5
39041,124,124,6,6,0,0,0.884962887,2
39043,287,183,18,18,0,104,0.544307232,4
39045,255,223,22,22,0,32,0.699324697,7
39047,25,25,5,5,0,0,0.393753439,2
39049,5514,5487,583,583,260,27,12.58317411,149
39051,117,25,7,7,0,92,0.275287658,2
39053,287,157,14,14,0,130,0.251653433,3
39055,124,124,12,12,0,0,0.550331414,6
39057,263,235,20,20,0,28,1.065161824,5
39059,255,156,11,11,0,99,0.949400872,4
39061,4627,3739,349,349,163,888,10.60544216,95
39063,201,166,29,29,0,35,0.583592735,6
39065,25,25,4,4,0,0,0.146958902,2
39067,25,25,4,4,0,0,0.097643837,2
39069,31,25,5,5,0,6,0.286027402,2
39071,70,50,8,8,0,20,0.780164391,4
39073,25,25,4,4,0,0,0.410520554,2
39075,69,41,4,4,0,28,0.257734716,2
39077,139,98,12,12,0,41,0.630179137,3
39079,25,24,6,6,0,1,0.311643839,2
39081,256,171,20,20,0,85,0.482592314,6
39083,111,65,12,12,0,46,0.499304533,2
39085,294,471,27,27,0,-177,1.269377381,7
39087,8,8,1,1,0,0,0.025684932,0
39089,262,262,20,20,0,0,0.996109337,11
39091,115,39,7,7,0,76,0.253459781,2
39093,887,838,62,62,0,49,4.417997003,15
39095,3434,2168,261,261,46,1266,7.7479617,61
39097,94,45,13,13,0,49,0.246453583,2
39099,1039,662,86,86,0,377,3.572666377,25
39101,174,174,15,15,0,0,0.355377108,3
39103,191,150,15,15,0,41,0.814989865,4
39107,88,42,5,5,0,46,0.363926947,2
39109,182,119,42,42,0,63,0.409117073,4
39113,2362,1977,252,252,125,385,5.746403039,43
39117,25,23,3,3,0,2,0.167123288,2
39119,321,282,24,24,0,39,0.499329656,12
39123,25,25,4,4,0,0,0.12142466,2
39125,25,25,4,4,0,0,0.183452055,1
39129,83,83,8,8,0,0,0.246273234,2
39131,25,25,4,4,0,0,0.288328767,2
39133,302,191,16,16,0,111,0.391637385,6
39139,409,279,41,41,0,130,1.389874309,8
39141,261,189,12,12,0,72,0.560542166,15
39143,245,152,18,18,0,93,0.301398881,5
39145,446,202,18,18,0,244,0.706050619,7
39147,144,69,5,5,0,75,0.985213071,2
39149,90,61,7,7,0,29,0.281967223,2
39151,1675,1006,129,129,0,669,3.359008729,34
39153,2527,2096,231,231,40,431,6.198248476,54
39155,752,517,43,43,0,235,2.857930511,9
39157,174,153,14,14,0,21,0.351460621,7
39159,97,60,7,7,0,37,0.236940637,3
39161,195,145,5,5,0,50,1.067837097,2
39165,372,265,22,22,0,107,1.119413227,5
39167,243,213,15,15,0,30,0.903271347,10
39169,184,129,18,18,0,55,0.696457326,8
39171,123,100,11,11,0,23,0.60292238,2
39173,149,149,18,18,0,0,0.197739065,3
39175,31,24,4,4,0,7,0.43710047,1
40001,67,30,5,5,0,37,0.494520545,1
40005,25,25,4,4,0,0,0.299835622,1
40007,24,24,4,4,0,0,0.075228311,1
40009,62,34,6,6,0,28,0.500241756,3
40011,42,42,7,7,0,0,0.208541505,0
40013,148,140,8,8,0,8,0.333326817,5
40015,42,42,7,7,0,0,1.247671247,0
40017,75,74,8,8,0,1,0.50062269,2
40019,212,162,17,17,0,50,0.676826179,4
40021,150,122,23,23,0,28,0.90836671,6
40023,34,34,6,6,0,0,0.31297341,2
40025,25,25,4,4,0,0,0.102136984,1
40027,658,533,70,70,0,125,1.788306773,15
40029,20,20,3,3,0,0,0.212876707,0
40031,550,365,35,35,0,185,1.871408328,9
40035,255,235,6,6,0,20,0.2325636,2
40037,95,95,18,18,0,0,1.285406798,2
40039,80,70,8,8,0,10,0.340322673,4
40041,58,58,6,6,0,0,0.26230514,2
40043,18,18,3,3,0,0,0.242922381,0
40045,23,25,4,4,0,-2,0.087013699,1
40047,436,349,34,34,0,87,1.093942165,9
40049,26,26,5,5,0,0,0.695363522,1
40051,75,49,9,9,0,26,0.19312273,2
40055,18,18,3,3,0,0,0.248706236,1
40057,25,22,4,4,0,3,0.228020951,0
40059,25,15,3,3,0,10,0.171872139,0
40063,25,25,4,4,0,0,0.296438366,2
40065,49,49,6,6,0,0,0.485602468,3
40067,18,25,4,4,0,-7,0.111890413,0
40069,25,25,4,4,0,0,0.180493146,1
40071,189,82,16,16,0,107,0.563436732,5
40073,25,25,4,4,0,0,0.217315063,1
40075,38,38,7,7,0,0,0.166690692,2
40077,43,43,8,8,0,0,0.20579803,1
40079,43,25,4,4,0,18,0.414323866,2
40081,50,50,8,8,0,0,1.072000012,1
40083,25,25,4,4,0,0,0.246575341,2
40085,25,25,4,4,0,0,0.351561636,1
40087,39,39,7,7,0,0,0.116543733,1
40089,25,25,6,6,0,0,0.416328758,1
40093,25,25,4,4,0,0,0.0889863,0
40095,25,21,4,4,0,4,0.216699287,1
40097,48,24,4,4,0,24,0.135844752,2
40099,25,25,4,4,0,0,0.655890405,0
40101,384,328,34,34,0,56,1.314404488,12
40103,26,26,5,5,0,0,0.160022452,1
40105,25,25,4,4,0,0,0.202490836,1
40107,24,25,4,4,0,-1,0.075068496,0
40109,4701,3683,482,482,186,1018,13.38549867,91
40111,115,119,15,15,0,-4,1.365208402,3
40113,40,40,7,7,0,0,0.672547966,2
40115,70,144,9,9,0,-74,0.146779358,2
40117,14,14,2,2,0,0,0.451859087,0
40119,216,161,11,11,0,55,0.38948749,6
40121,164,132,15,15,0,32,1.183571041,4
40123,276,240,25,25,0,36,1.542648405,4
40125,130,111,19,19,0,19,0.990635961,7
40127,23,42,7,7,0,-19,0.253685594,0
40129,15,15,3,3,0,0,0.15835616,0
40131,127,100,14,14,0,27,0.534109816,3
40133,32,32,6,6,0,0,0.179708898,2
40135,41,41,7,7,0,0,0.157434016,1
40137,110,86,9,9,0,24,0.436827004,2
40139,33,47,8,8,,-14,0.156170219,1
40143,4638,3026,344,344,120,1612,11.62282605,114
40145,100,100,6,6,0,0,0.376931518,2
40147,140,81,14,14,0,59,0.42531544,6
40149,14,14,2,2,0,0,0.194324851,0
40151,25,25,4,4,0,0,0.205779031,1
40153,115,64,6,6,0,51,0.973652974,2
41001,36,21,2,2,0,15,0.287018925,2
41003,188,169,12,12,0,19,0.53736794,4
41005,699,570,70,70,20,129,2.207786173,10
41007,83,48,8,8,0,35,0.89855969,4
41011,218,166,18,18,0,52,1.227206469,9
41013,16,16,3,3,0,0,0.464554787,2
41015,24,16,3,3,0,8,0.310787678,1
41017,304,270,36,36,0,34,1.161309093,8
41019,190,156,35,35,0,34,0.804765165,8
41023,25,14,2,2,0,11,0.4003914,0
41025,25,19,2,2,0,6,0.244989187,2
41027,25,25,4,4,0,0,0.432438344,2
41029,595,471,34,34,0,124,1.484973192,18
41031,25,25,4,4,0,0,0.284383565,2
41033,125,122,12,12,0,3,0.547069371,4
41035,176,105,18,18,0,71,0.439582527,2
41037,24,24,4,4,0,0,0.314041108,1
41039,749,721,84,84,36,28,2.795034736,13
41041,50,50,8,8,0,0,0.758794516,4
41043,128,92,15,15,0,36,0.937359244,4
41045,49,44,8,8,0,5,0.301681191,3
41047,1120,1067,68,68,27,53,2.351390034,19
41049,21,21,4,4,0,0,0.288193077,1
41051,2987,2131,261,261,152,856,4.66800949,41
41053,25,15,3,3,0,10,0.239634708,1
41057,49,25,4,4,0,24,0.483178079,2
41059,114,66,11,11,0,48,0.907287657,4
41061,25,25,4,4,0,0,0.449205488,2
41063,25,23,4,4,0,2,0.28528887,2
41065,49,43,17,17,0,6,0.3728576,4
41067,840,779,69,69,47,61,2.623400539,13
41071,128,90,11,11,0,38,1.11245203,4
42001,76,76,8,8,0,0,0.581759214,4
42003,7109,6092,638,638,218,1017,13.22073494,88
42005,147,131,12,12,0,16,0.307769537,2
42007,320,229,25,25,0,91,1.019370973,5
42009,40,40,4,4,0,0,0.275646865,2
42011,1326,1142,74,74,36,184,4.065681159,12
42013,518,496,42,42,0,22,1.899525478,12
42015,314,310,46,46,0,4,1.681114912,15
42017,1137,993,183,183,10,144,3.820314825,33
42019,296,266,35,35,0,30,0.556854486,3
42021,537,423,26,26,16,114,1.408137396,18
42025,159,68,6,6,0,91,0.507373095,3
42027,452,432,43,43,0,20,1.916727275,5
42029,1175,1133,105,105,18,42,3.233277172,25
42031,182,169,7,7,0,13,1.054862916,2
42033,266,241,22,22,16,25,0.903637946,10
42035,63,63,11,11,0,0,0.28672035,2
42037,166,143,22,22,0,23,0.264216542,4
42039,283,170,16,16,0,113,0.94431743,4
42041,683,612,61,61,5,71,2.628831297,18
42043,1395,1261,97,97,79,134,3.843004227,25
42045,1071,948,94,94,24,123,2.194426239,42
42047,35,25,4,4,0,10,0.588821948,2
42049,1160,1040,81,81,45,120,2.833284914,26
42051,224,210,26,26,0,14,0.8764624,5
42055,454,411,80,80,7,43,1.538307339,9
42057,21,21,4,4,0,0,0.337508142,1
42059,23,23,4,4,0,0,0.352948189,2
42061,71,57,7,7,0,14,0.294736832,2
42063,166,134,12,12,0,32,0.402923733,2
42065,84,69,9,9,0,15,0.791651309,4
42069,977,855,53,53,15,122,2.888742566,18
42071,1106,936,73,73,34,170,2.739679545,20
42073,153,206,12,12,0,-53,0.518119752,3
42075,407,393,20,20,0,14,1.47694546,7
42077,1544,1624,181,181,50,-80,3.823218316,34
42079,1118,974,74,74,14,144,3.471330374,29
42081,331,303,35,35,0,28,1.837398797,13
42083,138,138,10,10,0,0,0.476618618,4
42085,433,404,28,28,0,29,0.885283647,9
42087,123,109,10,10,0,14,0.304662555,3
42089,339,295,32,32,0,44,1.214254767,9
42091,3200,3023,289,289,31,177,9.06415233,58
42093,792,757,75,75,55,35,3.140335143,23
42095,906,774,54,54,16,132,2.06067273,24
42101,6872,5715,847,847,245,1157,16.96022884,258
42105,49,25,4,4,0,24,0.535232902,2
42107,364,266,58,58,0,98,1.790711284,14
42111,185,148,23,23,0,37,0.61067085,6
42115,50,50,8,8,0,0,0.606137007,0
42117,25,25,6,6,0,0,0.614794493,3
42119,132,123,12,12,0,9,0.372825474,4
42121,158,118,8,8,0,40,0.433203697,3
42123,237,237,6,6,0,0,1.238502711,2
42125,578,448,55,55,0,130,1.407594442,8
42127,95,76,8,8,0,19,0.364599854,3
42129,980,794,77,77,0,186,3.164154947,15
42131,44,44,6,6,0,0,0.060958903,2
42133,967,808,93,93,44,159,3.091142058,23
44003,359,323,15,15,0,36,0.499724329,9
44005,129,102,10,10,0,27,0.415820569,3
44007,2700,2425,333,333,80,275,4.903725103,47
44009,225,158,17,17,0,67,1.075637221,5
45001,25,25,6,6,0,0,0.31813699,2
45003,273,204,35,35,0,69,0.633817196,9
45005,25,25,4,4,0,0,0.132054791,1
45007,721,460,25,25,0,261,2.32710284,18
45013,364,318,24,24,0,46,1.616050631,8
45015,50,,32,32,,50,,0
45019,2130,1830,302,302,80,300,5.188476354,68
45021,125,44,12,12,0,81,0.343240082,2
45023,82,36,6,6,0,46,0.213944077,2
45025,59,48,6,6,0,11,0.557363033,2
45027,81,49,6,6,0,32,0.416941583,2
45029,135,102,8,8,0,33,0.372817606,3
45031,188,152,18,18,0,36,0.856292963,3
45033,79,72,6,6,0,7,0.290220708,2
45037,25,25,4,4,0,0,0.528791189,1
45041,1003,969,135,135,48,34,2.839044094,31
45043,284,330,19,19,0,-46,1.255677015,7
45045,2497,1454,150,150,70,1043,5.174043387,43
45047,400,332,25,25,18,68,1.172318876,10
45049,32,32,6,6,0,0,0.21934931,2
45051,832,741,101,101,0,91,2.732106656,23
45053,41,41,4,4,0,0,0.60380888,3
45055,119,121,10,10,0,-2,0.397531539,3
45057,274,208,20,20,0,66,1.165889591,4
45059,76,47,9,9,0,29,0.417779088,3
45063,630,603,39,39,0,27,1.4186064,22
45067,124,94,10,10,0,30,0.207200229,2
45071,90,48,7,7,0,42,0.368949771,2
45073,169,133,21,21,0,36,0.401944041,5
45075,301,266,20,20,0,35,0.453244567,5
45077,164,111,20,20,0,53,0.604920715,5
45079,2171,2058,144,144,142,113,4.471389443,39
45083,932,947,49,49,27,-15,2.860589385,32
45085,283,173,17,17,0,110,0.684915662,8
45087,85,43,6,6,0,42,0.153743237,2
45089,25,25,4,4,0,0,0.263999999,2
45091,338,318,24,24,0,20,1.538733602,9
46005,25,25,6,6,0,0,0.552547932,2
46007,14,14,2,2,0,0,0.223091975,0
46009,45,50,8,8,0,-5,0.261369854,1
46011,49,49,9,9,0,0,0.222980157,2
46013,157,97,14,14,0,60,0.883275092,4
46015,25,25,4,4,0,0,0.190136984,0
46023,37,37,6,6,0,0,0.292836413,1
46027,25,25,4,4,0,0,0.246465757,2
46029,81,81,8,8,0,0,0.267782837,2
46033,11,11,2,2,0,0,0.328269005,0
46035,50,50,8,8,0,0,0.337260276,2
46037,25,20,3,3,0,5,0.12602739,0
46039,10,10,2,2,0,0,0.300273985,0
46043,11,11,2,2,0,0,0.201245323,0
46045,12,12,2,2,0,0,0.221232876,0
46047,25,25,4,4,0,0,0.279671222,1
46049,12,12,2,2,0,0,0.246118724,0
46051,25,25,4,4,0,0,0.152109593,1
46053,41,41,7,7,0,0,0.470082194,1
46055,18,18,3,3,0,0,0.625875175,0
46059,11,25,4,4,0,-14,0.11452055,0
46065,50,50,6,6,0,0,0.229424655,2
46067,50,50,8,8,0,0,0.360328779,0
46073,16,16,3,3,0,0,0.11130137,0
46077,6,6,1,1,0,0,0.106392696,1
46079,22,22,4,4,0,0,0.434371114,1
46081,62,45,5,5,0,17,0.739421606,1
46083,64,64,11,11,0,0,0.771160036,2
46089,4,4,1,1,0,0,0.20869565,0
46091,20,20,3,3,0,0,0.113972604,0
46093,79,79,3,3,0,0,0.543013692,1
46099,1197,1036,110,110,43,161,2.598646551,52
46101,18,18,3,3,0,0,0.075494669,0
46102,45,45,8,8,0,0,0.255340844,0
46103,449,402,76,76,28,47,1.071376789,6
46107,6,10,2,2,0,-4,0.280547947,0
46109,25,25,4,4,0,0,0.188164383,1
46115,25,23,4,4,0,2,0.175699815,0
46121,35,35,6,6,0,0,0.102622308,0
46123,25,25,4,4,0,0,0.30399999,1
46125,12,12,2,2,0,0,0.131963477,0
46127,38,38,7,7,0,0,0.226387888,0
46129,25,25,4,4,0,0,0.250082195,1
46135,242,168,12,12,0,74,0.74882048,2
46137,8,8,1,1,0,0,0.283904105,0
47001,317,220,25,25,0,97,1.3389135,6
47003,60,44,8,8,0,16,0.207036108,2
47005,25,25,4,4,0,0,0.14191781,0
47007,25,25,4,4,0,0,0.224219173,1
47009,459,348,8,8,0,111,0.691929877,4
47011,251,177,27,27,0,74,0.599767804,4
47013,120,82,10,10,0,38,0.539542668,4
47015,60,30,5,5,0,30,0.218904108,1
47017,70,42,7,7,0,28,0.333137631,2
47019,121,109,8,8,0,12,0.295262039,2
47021,12,12,2,2,0,0,0.481278539,0
47025,85,33,5,5,0,52,0.294507265,2
47027,,,0,0,,0,0.293114752,
47029,74,32,5,5,0,42,0.628424644,2
47031,160,123,22,22,0,37,0.661526725,5
47035,189,73,12,12,0,116,0.68575716,6
47037,4372,3131,604,604,239,1241,8.17839098,93
47041,71,52,4,4,0,19,0.075079031,2
47043,157,91,6,6,0,66,0.595293045,5
47045,225,109,14,14,0,116,0.397816747,3
47051,152,131,10,10,0,21,0.225770548,2
47053,70,47,3,3,0,23,0.109472454,2
47055,95,81,6,6,0,14,0.197294101,2
47059,240,189,17,17,0,51,0.519533753,5
47063,167,116,20,20,0,51,0.601936698,5
47065,1735,1703,188,188,110,32,5.583796024,47
47067,10,10,2,2,0,0,0.186575338,1
47069,238,175,4,4,0,63,0.921214581,0
47071,58,49,9,9,0,9,0.228347778,2
47073,50,32,6,6,0,18,0.251883566,2
47077,45,36,6,6,0,9,0.078386605,1
47079,142,64,11,11,0,78,0.404452056,2
47081,25,25,4,4,0,0,0.068273969,0
47083,25,25,4,4,0,0,0.147397265,1
47085,25,25,4,4,0,0,0.248109594,0
47089,58,58,6,6,0,0,0.44591403,2
47091,2,2,1,1,0,0,0.089041099,1
47093,1733,1606,260,260,84,127,4.48558259,45
47097,25,25,4,4,0,0,0.16613698,0
47099,99,89,6,6,0,10,0.189533636,3
47103,59,49,6,6,0,10,0.174839258,2
47105,50,30,5,5,0,20,0.876164377,2
47107,118,88,4,4,0,30,0.286021173,3
47111,25,25,4,4,0,0,0.400219172,1
47113,900,870,89,89,34,30,2.729053855,20
47117,25,25,4,4,0,0,0.074082188,1
47119,271,281,41,41,0,-10,1.165754199,6
47123,59,59,10,10,0,0,0.427908063,2
47125,337,301,21,21,13,36,0.903161228,5
47131,173,63,11,11,0,110,0.290889323,2
47133,114,90,6,6,0,24,0.199665144,2
47135,53,21,4,4,0,32,0.21578604,0
47141,285,247,38,38,0,38,1.40830934,8
47143,25,25,3,3,0,0,0.316602737,2
47145,54,52,6,6,0,2,0.535089552,2
47147,109,109,8,8,0,0,0.231946707,4
47149,838,759,82,82,25,79,1.221338479,12
47151,25,25,4,4,0,0,0.179616436,2
47155,79,58,16,16,0,21,0.667879045,3
47157,4052,3283,353,353,220,769,11.36856026,84
47159,25,25,2,2,0,0,0.384328753,2
47163,1211,851,101,101,20,360,3.352027446,36
47165,265,255,38,38,6,10,1.111236036,7
47167,100,47,8,8,0,53,0.116700672,2
47169,25,23,4,4,0,2,0.118880287,0
47171,48,10,3,3,0,38,0.382191777,2
47177,125,100,8,8,0,25,0.122876711,3
47179,607,561,77,77,39,46,1.99168241,15
47181,80,30,5,5,0,50,0.24968037,1
47183,156,94,7,7,0,62,1.441334769,2
47185,60,32,4,4,0,28,0.117123291,2
47187,310,305,29,29,0,5,1.766169339,3
47189,170,170,12,12,0,0,0.201616034,3
48001,156,150,10,10,0,6,0.427373648,2
48003,34,30,5,5,0,4,0.131050229,2
48005,465,367,43,43,15,98,2.543040693,12
48013,67,67,6,6,0,0,0.202044576,2
48015,30,32,6,6,0,-2,0.072431505,0
48017,25,25,4,4,0,0,0.155178085,1
48021,8,8,1,1,0,0,0.193150684,2
48023,25,27,5,5,0,-2,0.18812786,1
48025,69,40,8,8,0,29,0.332671225,2
48027,1125,1129,95,95,72,-4,2.864121646,50
48029,5873,6451,659,659,445,-578,12.74097396,124
48035,25,25,4,4,0,0,0.336109579,2
48037,821,679,71,71,8,142,2.815305799,19
48039,267,183,19,19,0,84,2.333091125,8
48041,684,579,85,85,16,105,3.16098962,27
48043,25,25,3,3,0,0,0.29621917,2
48049,188,63,12,12,0,125,0.381748438,3
48051,25,15,3,3,0,10,0.35926941,1
48053,71,71,12,12,0,0,0.729598552,5
48055,58,57,10,10,0,1,1.126489669,4
48057,25,25,6,6,0,0,0.38104111,2
48061,1374,1177,105,105,78,197,5.006359279,39
48063,25,25,4,4,0,0,0.328436375,2
48069,17,17,3,3,0,0,0.247703463,0
48071,14,14,2,2,0,0,0.062426616,0
48073,385,343,10,10,0,42,1.661015332,4
48075,39,37,7,7,0,2,0.168752313,2
48077,25,25,4,4,0,0,0.055671234,0
48079,18,18,3,3,0,0,0.002739726,0
48083,25,25,4,4,0,0,0.335232884,2
48085,2571,2170,276,276,168,401,11.30156349,67
48087,13,13,2,2,0,0,0.171338245,0
48089,65,61,11,11,0,4,0.282354861,3
48091,208,192,24,24,16,16,1.870660484,8
48093,25,25,4,4,0,0,0.292273968,2
48095,16,16,3,3,0,0,0.054280821,0
48097,78,54,8,8,0,24,0.937138468,2
48099,25,25,4,4,0,0,0.278027385,2
48103,25,25,4,4,0,0,0.071561642,0
48107,25,25,4,4,0,0,0.072986305,0
48109,14,14,2,2,0,0,0.204305291,0
48113,8257,7071,755,755,495,1186,21.76043717,181
48115,21,22,4,4,0,-1,0.139227897,1
48117,42,32,5,5,0,10,0.166523978,1
48121,1484,1267,156,156,31,217,6.602953099,29
48123,49,44,8,8,0,5,0.180074722,2
48127,25,25,4,4,,0,0.251068503,2
48133,52,36,6,6,0,16,0.247336373,2
48135,638,510,34,34,79,128,1.566095948,12
48139,189,166,18,18,0,23,0.776419774,9
48141,2598,2284,246,246,140,314,7.585493132,50
48143,98,50,5,5,0,48,0.193753421,2
48145,36,36,6,6,0,0,0.033105023,1
48147,311,317,2,2,0,-6,0.496876717,2
48149,65,38,7,7,0,27,0.265753418,2
48151,14,14,2,2,0,0,0.113307238,0
48153,25,25,4,4,0,0,0.128547952,1
48157,1175,1062,129,129,17,113,5.024678692,29
48161,37,37,6,6,0,0,0.074717753,1
48163,22,24,4,4,,-2,0.194520548,1
48165,33,25,4,4,0,8,0.385753423,1
48167,815,815,38,38,64,0,1.423483908,16
48171,84,57,10,10,0,27,0.331891358,2
48177,33,34,6,6,0,-1,0.164464146,2
48179,109,97,8,8,0,12,0.130377069,2
48181,676,663,73,73,12,13,3.038563371,25
48183,741,644,62,62,52,97,2.586361349,18
48185,25,18,3,3,0,7,0.325875193,1
48187,153,117,9,9,0,36,0.255988747,5
48189,88,69,5,5,0,19,0.307632089,2
48193,25,25,7,7,0,0,0.301569611,1
48195,14,14,2,2,0,0,0.189823881,2
48197,24,24,4,4,0,0,0.113356166,0
48199,,,0,0,,0,,
48201,15385,12817,1643,1643,635,2568,35.19485613,351
48203,149,149,42,42,31,0,0.53956157,7
48205,21,21,4,4,0,0,0.261839539,0
48207,25,25,4,4,0,0,0.093150683,0
48209,435,391,79,79,4,44,2.041004617,9
48211,26,15,3,3,0,11,0.194155246,0
48213,127,127,10,10,0,0,0.35739401,3
48215,1421,1185,260,260,147,236,4.414040014,45
48217,25,25,4,4,0,0,0.101831272,2
48219,48,48,8,8,0,0,0.120605022,2
48221,73,48,12,12,0,25,0.625342488,3
48223,96,56,14,14,0,40,0.433953047,4
48225,25,25,4,4,0,0,0.059565216,1
48227,290,219,8,8,0,71,1.230065361,2
48231,221,176,16,16,0,45,1.337215841,9
48233,25,25,4,4,0,0,0.241643831,2
48237,17,17,3,3,0,0,0.200161159,1
48239,25,25,4,4,0,0,0.149150684,0
48241,59,40,6,6,0,19,0.119178079,2
48245,1198,1210,143,143,55,-12,3.892102048,29
48249,135,72,8,8,0,63,0.287442923,2
48251,137,92,7,7,0,45,0.256491959,2
48253,45,7,1,1,0,38,0.718590975,0
48255,25,25,4,4,0,0,0.159671232,2
48257,379,351,8,8,0,28,1.094585791,2
48265,342,302,12,12,0,40,1.334274411,3
48267,15,15,3,3,0,0,0.100639269,0
48273,96,50,10,10,0,46,0.535452068,2
48275,25,28,5,5,0,-3,0.039999999,2
48277,154,154,20,20,0,0,0.239142343,9
48279,75,42,7,7,0,33,0.052511416,0
48281,25,25,4,4,0,0,0.349808216,2
48285,48,50,7,7,0,-2,0.488328755,3
48291,41,41,8,8,0,0,0.133000433,3
48293,78,69,9,9,0,9,0.327880912,3
48299,27,25,4,4,0,2,0.05731507,2
48303,2115,1954,338,338,91,161,4.199854314,38
48305,24,24,4,4,0,0,0.232990861,2
48307,25,14,6,6,0,11,0.221330717,2
48309,473,437,42,42,30,36,1.396861434,24
48313,25,15,3,3,0,10,0.593789935,1
48317,18,18,3,3,0,0,0.246270925,0
48321,75,63,9,9,0,12,0.401362859,4
48323,101,86,10,10,0,15,0.448136359,3
48325,25,25,4,4,0,0,0.289095879,2
48329,616,368,40,40,0,248,2.027828872,5
48335,25,25,4,4,0,0,0.262684941,2
48337,71,55,9,9,0,16,0.464083269,1
48339,1710,1732,212,212,50,-22,5.280619822,51
48341,25,19,3,3,0,6,0.453929335,2
48347,392,297,27,27,16,95,0.564977229,7
48349,162,49,9,9,0,113,0.32239306,2
48353,86,39,5,5,0,47,0.270530373,2
48355,1356,1024,123,123,40,332,4.239085361,33
48357,25,25,4,4,0,0,0.221150681,1
48363,74,48,8,8,0,26,0.337442935,2
48365,42,42,7,7,0,0,0.13881278,2
48367,129,108,20,20,0,21,1.174031734,3
48369,25,25,4,4,0,0,0.121643834,0
48371,39,39,6,6,0,0,0.333933473,2
48373,66,52,8,8,0,14,0.323393047,2
48375,930,818,125,125,56,112,2.564712554,29
48383,7,7,1,1,0,0,0.088454008,0
48389,25,25,4,4,0,0,0.322410971,2
48391,20,20,3,3,0,0,0.082602739,2
48397,245,182,21,21,17,63,1.36378406,7
48399,50,31,6,6,0,19,0.343778536,0
48401,96,41,7,7,0,55,0.210090205,2
48403,25,25,4,4,0,0,0.143999994,1
48405,18,9,2,2,0,9,0.19878234,2
48413,14,14,2,2,0,0,0.06771037,0
48415,25,25,4,4,0,0,0.262027383,2
48423,1744,1632,306,306,0,112,5.242347322,37
48425,16,16,3,3,0,0,0.127739727,2
48427,48,48,8,8,0,0,0.170719177,2
48429,40,14,2,2,0,26,0.207827792,2
48433,20,20,3,3,0,0,0.10232877,1
48435,12,12,2,2,0,0,0.10022831,0
48437,20,20,3,3,0,0,0.218356162,0
48439,6909,5940,744,744,380,969,21.12590291,127
48441,977,733,71,71,41,244,2.981803,23
48445,45,26,5,5,0,19,0.156902,1
48447,14,14,2,2,0,0,0.077299416,0
48449,174,49,8,8,0,125,0.541794777,3
48451,584,563,29,29,10,21,1.423882812,7
48453,3135,2893,430,430,269,242,12.18398577,63
48457,49,25,4,4,0,24,0.094356164,2
48461,29,26,5,5,0,3,0.147148192,0
48463,25,21,6,6,0,4,0.569732547,2
48465,93,47,7,7,0,46,0.371611774,2
48469,627,588,83,83,8,39,3.496144786,12
48471,123,90,6,6,0,33,0.610865533,2
48475,25,21,4,4,0,4,0.272146106,0
48477,60,50,5,5,0,10,0.2219726,2
48479,557,525,65,65,29,32,2.731009841,19
48481,94,26,36,36,0,68,0.28883034,2
48483,41,41,7,7,0,0,0.153527401,0
48485,840,812,28,28,0,28,4.276878849,14
48487,28,28,8,8,0,0,0.272994131,1
48491,971,843,157,157,20,128,5.126297245,27
48493,44,44,4,4,0,0,0.178206727,2
48495,19,19,3,3,0,0,0.120980531,1
48497,99,49,21,21,0,50,0.653610706,4
48499,50,48,8,8,0,2,0.636426419,3
48501,24,24,4,4,0,0,0.133675799,1
48503,50,50,8,8,0,0,0.568328768,3
49001,72,30,5,5,0,42,0.846356168,0
49003,74,56,10,10,0,18,0.319212332,3
49005,168,152,18,18,0,16,0.426870391,3
49007,39,49,6,6,0,-10,0.288795233,2
49011,433,311,37,37,15,122,1.470895693,7
49013,49,32,4,4,0,17,0.319528103,2
49017,36,15,3,3,0,21,0.193424657,0
49019,17,17,3,3,0,0,0.351974219,2
49021,48,48,6,6,0,0,0.298116446,2
49023,25,25,4,4,0,0,0.401315063,1
49025,25,25,4,4,0,0,0.539287686,1
49027,37,37,6,6,0,0,0.745934442,0
49035,3366,2792,312,312,139,574,8.441132829,50
49037,36,32,3,3,0,4,0.403605536,2
49039,43,43,7,7,0,0,0.559841692,3
49041,29,24,4,4,0,5,0.25,1
49043,38,37,4,4,0,1,0.247201741,1
49045,44,36,4,4,0,8,0.267503798,2
49047,39,39,4,4,0,0,0.223744288,2
49049,1316,1187,136,136,96,129,4.043543324,14
49051,19,19,3,3,0,0,0.222425744,0
49053,245,164,32,32,24,81,0.632175326,5
49057,593,457,101,101,17,136,1.416080713,9
50001,45,25,4,4,0,20,0.59386301,1
50003,99,78,10,10,0,21,0.407692313,3
50005,75,25,4,4,0,50,0.710027397,2
50007,562,422,66,66,0,140,0.746721923,15
50011,70,53,9,9,0,17,0.366141111,3
50015,43,25,4,4,0,18,0.523397267,2
50017,52,25,2,2,0,27,0.511780798,2
50019,49,25,5,5,0,24,0.609534264,2
50021,188,124,13,13,0,64,0.71058327,2
50023,130,101,14,14,0,29,1.626014352,3
50025,229,185,11,11,0,44,1.764699072,2
50027,164,50,9,9,0,114,1.409753442,4
51001,52,46,10,10,0,6,0.485765338,3
51003,266,240,18,18,0,26,2.085077643,8
51005,205,95,10,10,0,110,0.159711614,2
51013,394,305,32,32,0,89,0.798122585,11
51015,238,209,8,8,0,29,0.465081334,5
51017,25,14,2,2,0,11,0.371232867,1
51019,50,34,6,6,0,16,0.410072535,2
51027,134,49,12,12,0,85,0.290466875,2
51041,450,450,96,96,35,0,2.293874681,24
51047,70,70,6,6,0,0,0.441996098,3
51051,25,2,1,1,0,23,0.117808223,1
51053,130,130,1,1,0,0,0.178082198,0
51057,67,67,7,7,0,0,0.223062769,2
51059,2810,2581,336,336,124,229,4.033882588,51
51061,97,97,8,8,0,0,0.438073725,3
51067,37,37,4,4,0,0,0.365124017,2
51071,25,25,4,4,0,0,0.487342477,2
51073,67,67,7,7,0,0,0.42277652,3
51083,192,107,12,12,0,85,0.373166054,5
51085,265,265,27,27,0,0,1.726508379,10
51087,1258,818,103,103,58,440,2.472496718,23
51095,106,97,7,7,0,9,1.732401252,0
51103,35,25,4,4,0,10,0.382356167,2
51107,451,429,33,33,0,22,1.750928216,8
51117,85,70,12,12,0,15,0.595848918,2
51121,292,202,22,22,0,90,0.936613232,9
51127,94,94,36,36,,0,,0
51135,180,180,32,32,0,0,0.579847813,0
51139,25,25,4,4,0,0,0.40438357,2
51147,116,86,8,8,0,30,0.453806937,4
51153,243,207,24,24,0,36,1.060699821,10
51155,147,92,8,8,0,55,0.163341269,2
51161,270,270,0,0,0,0,0.375413507,0
51165,238,238,34,34,0,0,0.585645199,12
51167,78,48,5,5,0,30,0.311872154,2
51171,25,25,4,4,0,0,0.552219152,2
51173,153,139,4,4,0,14,1.096337825,2
51177,133,105,12,12,0,28,0.549615145,4
51179,100,90,4,4,0,10,0.444901079,3
51185,207,207,22,22,0,0,0.307546876,5
51187,68,46,8,8,0,22,0.367957115,2
51191,116,115,14,14,0,1,0.633543789,5
51195,134,68,8,8,0,66,0.190572113,3
51197,92,92,6,6,0,0,0.172721863,2
51199,195,189,16,16,0,6,1.219885647,5
51510,323,339,40,40,16,-16,1.225100458,11
51520,25,25,0,0,0,0,0.854684949,0
51540,612,585,14,14,85,27,0.748310506,19
51550,310,310,28,28,0,0,0.614432156,11
51590,322,367,34,34,0,-45,1.355767101,7
51595,80,70,7,7,0,10,0.11358121,2
51620,90,75,8,8,0,15,0.147433788,2
51630,509,479,28,28,17,30,1.53117317,17
51640,141,141,10,10,0,0,0.210648015,4
51650,363,311,25,25,0,52,1.105674356,9
51670,147,107,17,17,0,40,0.364306748,4
51678,25,25,4,4,0,0,0.463452041,2
51680,570,394,43,43,13,176,1.263795733,23
51683,130,94,11,11,10,36,0.593587875,3
51700,856,605,40,40,0,251,1.932106704,17
51710,1379,1234,217,217,93,145,3.843772382,43
51720,129,63,11,11,0,66,0.334333539,3
51730,572,488,29,29,0,84,1.642899334,6
51740,548,417,23,23,0,131,0.570385456,7
51760,1115,1016,197,197,61,99,1.116915375,27
51770,737,621,47,47,68,116,0.720418692,33
51775,506,330,25,25,0,176,0.650593579,12
51790,132,132,18,18,0,0,0.916797101,0
51800,178,155,12,12,0,23,0.668121934,7
51810,547,487,39,39,0,60,2.317452967,22
51830,40,40,10,10,0,0,0.337808222,2
51840,455,389,48,48,0,66,0.71161741,21
53001,69,28,5,5,0,41,0.583447486,1
53003,62,25,4,4,0,37,0.488000005,2
53005,438,416,48,48,37,22,2.429917455,23
53007,265,221,28,28,6,44,2.156074554,9
53009,171,103,23,23,0,68,0.985336155,5
53011,814,746,99,99,22,68,1.346441507,19
53013,62,25,4,4,0,37,0.730849326,2
53015,346,166,18,18,0,180,0.509572566,3
53019,25,25,4,4,0,0,0.628712356,0
53021,95,25,4,4,0,70,0.649636984,2
53023,45,25,4,4,0,20,0.649205506,0
53025,173,123,24,24,0,50,1.758746551,3
53027,164,59,10,10,0,105,1.159083039,5
53029,37,30,6,6,0,7,0.591232896,2
53031,42,25,6,6,0,17,0.48569864,2
53033,5631,4245,636,636,211,1386,16.45041044,135
53035,419,334,20,20,0,85,0.551025093,14
53037,50,25,6,6,0,25,0.251287669,2
53039,57,28,4,4,0,29,0.604060933,2
53041,153,152,10,10,0,1,1.006185174,6
53043,50,50,8,8,0,0,1.446684957,1
53045,68,25,6,6,0,43,0.462136984,2
53047,112,71,12,12,0,41,0.586264849,5
53049,51,35,6,6,0,16,0.373698637,3
53051,74,20,4,4,0,54,0.265753418,2
53053,2873,2401,226,226,83,472,5.011718929,64
53055,10,10,2,2,0,0,0.062465753,0
53057,205,205,34,34,0,0,1.521128953,9
53061,993,863,72,72,38,130,2.831609666,25
53063,2666,1896,158,158,128,770,3.779773578,43
53065,120,48,8,8,0,72,0.902804017,3
53067,500,411,72,72,0,89,1.253668964,14
53071,142,120,28,28,6,22,0.497631133,5
53073,253,207,24,24,0,46,0.800092638,5
53075,61,50,10,10,0,11,0.698958904,4
53077,440,371,52,52,0,69,1.866587877,15
54001,72,12,2,2,0,60,0.456849307,1
54003,195,146,21,21,4,49,0.628785908,15
54005,25,25,4,4,0,0,0.441753417,2
54007,25,25,4,4,0,0,0.081753425,2
54009,238,199,21,21,0,39,0.426038176,9
54011,1051,995,85,85,61,56,4.787657917,31
54013,42,25,4,4,0,17,0.160876706,1
54019,94,50,7,7,0,44,0.788164377,3
54023,45,25,3,3,0,20,0.567232847,2
54025,122,92,12,12,0,30,0.339130431,2
54027,44,14,2,2,0,30,0.44324854,2
54033,483,423,20,20,0,60,0.634530008,17
54035,25,25,4,4,0,0,0.32734248,2
54037,25,25,5,5,0,0,0.414246589,3
54039,822,1106,143,143,26,-284,3.499645233,48
54041,220,220,6,6,0,0,1.136448815,2
54045,140,132,12,12,0,8,0.415255278,3
54047,124,49,7,7,0,75,0.128207996,2
54051,70,59,9,9,0,11,0.293893665,2
54053,201,49,5,5,0,152,0.372435004,2
54055,419,206,33,33,0,213,1.792260617,8
54057,25,25,4,4,0,0,0.239452049,2
54061,975,890,123,123,39,85,2.081373215,52
54065,41,25,4,4,0,16,0.345753431,2
54067,105,49,6,6,0,56,0.504844368,2
54069,408,317,35,35,0,91,1.048003316,8
54075,25,25,4,4,0,0,0.163835615,2
54077,25,25,4,4,0,0,0.364493161,2
54081,473,413,27,27,0,60,0.96312815,14
54083,80,90,16,16,0,-10,0.27223745,2
54087,60,25,4,4,0,35,0.300931513,2
54089,25,25,4,4,0,0,0.301369876,2
54091,25,25,4,4,0,0,0.307945192,1
54095,12,25,4,4,0,-13,0.030027397,2
54097,151,25,4,4,0,126,0.347616434,2
54099,80,80,1,1,,0,,2
54101,15,25,4,4,0,-10,0.06169863,1
54103,58,48,5,5,0,10,0.11375571,2
54107,342,270,18,18,0,72,1.457579076,12
55001,25,25,4,4,0,0,0.078904107,0
55003,35,25,4,4,0,10,0.435616434,2
55005,90,90,14,14,0,0,1.127821922,4
55009,1270,828,90,90,42,442,3.752455801,18
55013,25,25,4,4,0,0,0.069150686,0
55015,25,25,4,4,0,0,0.128547952,1
55017,218,127,10,10,0,91,0.858184248,4
55019,49,49,8,8,0,0,0.226602741,1
55021,98,68,10,10,0,30,0.609587759,3
55023,25,24,4,4,0,1,0.365981728,1
55025,2131,1790,104,104,127,341,4.483724892,42
55027,245,230,14,14,0,15,0.564450666,5
55029,25,25,4,4,0,0,0.424109578,2
55031,25,25,4,4,0,0,0.300054789,2
55033,25,25,5,5,0,0,0.390904099,2
55035,705,418,58,58,0,287,2.074878752,24
55039,189,158,15,15,0,31,1.289839178,4
55043,75,75,12,12,0,0,0.546849318,4
55045,95,58,6,6,0,37,0.408597082,2
55047,25,25,5,5,0,0,0.390356153,2
55049,25,25,4,4,0,0,0.322301358,2
55053,25,25,4,4,0,0,0.220383555,2
55055,49,49,4,4,0,0,0.250601053,2
55057,40,40,7,7,0,0,0.175410956,2
55059,389,274,27,27,0,115,1.161330342,6
55063,656,395,52,52,18,261,1.102170527,13
55065,25,25,4,4,0,0,0.119123287,0
55067,25,25,4,4,0,0,0.445589036,2
55069,43,40,7,7,0,3,0.231232874,2
55071,236,127,16,16,0,109,0.611837924,4
55073,440,338,52,52,14,102,2.074024975,26
55075,55,55,10,10,0,0,0.321192175,4
55079,4011,3152,483,483,112,859,7.85917604,68
55081,50,50,8,8,0,0,0.697753429,5
55083,35,32,6,6,0,3,0.372154415,1
55085,172,102,30,30,0,70,0.850678623,4
55087,517,466,69,69,15,51,1.318744957,13
55089,314,246,46,46,10,68,1.095840394,5
55091,25,25,4,4,0,0,0.142904103,0
55095,73,70,10,10,0,3,0.962849304,6
55097,94,84,12,12,0,10,0.358773649,2
55099,25,24,4,4,0,1,0.151484013,1
55101,476,343,39,39,18,133,1.682748169,10
55103,25,25,4,4,0,0,0.420931518,1
55105,562,367,36,36,0,195,1.727983981,9
55107,25,25,4,4,0,0,0.13731645,2
55109,100,100,16,16,0,0,1.001424655,8
55111,161,104,16,16,0,57,0.839712366,6
55113,25,25,4,4,0,0,0.308164388,1
55115,25,25,6,6,0,0,0.481315076,2
55117,370,189,13,13,6,181,0.682657033,4
55119,25,25,4,4,0,0,0.235287666,2
55121,43,43,9,9,0,0,0.872858465,4
55123,50,50,8,8,0,0,0.51583562,2
55125,25,14,2,2,0,11,0.296673179,1
55127,134,79,16,16,0,55,0.842368394,4
55129,50,45,7,7,0,5,0.461443961,1
55131,141,105,12,12,0,36,0.913659483,7
55133,1070,710,64,64,34,360,4.669818521,16
55135,25,25,4,4,0,0,0.34147945,2
55137,25,25,4,4,0,0,0.203945205,2
55139,795,687,60,60,0,108,2.30121842,14
55141,619,262,16,16,26,357,2.009977579,9
56001,99,66,4,4,0,33,0.190452471,3
56003,25,22,4,4,0,3,0.804520547,1
56005,90,66,14,14,0,24,0.258322954,2
56007,25,25,6,6,0,0,0.186849311,2
56009,25,25,5,5,0,0,0.28701371,2
56011,16,16,3,3,0,0,0.189726025,1
56013,146,133,12,12,0,13,0.128828928,2
56015,25,25,4,4,0,0,0.192767128,2
56017,25,25,4,4,0,0,0.173917815,2
56019,25,22,4,4,0,3,0.275342464,1
56021,236,200,16,16,0,36,0.513360202,6
56023,38,35,8,8,0,3,0.424983226,4
56025,414,372,27,27,0,42,2.085640609,13
56027,24,24,4,4,0,0,0.832990885,0
56029,50,50,8,8,0,0,0.703452066,4
56031,25,25,4,4,0,0,0.167780817,2
56033,88,71,12,12,0,17,0.367521375,3
56037,115,74,13,13,0,41,0.216816247,2
56039,48,48,6,6,0,0,0.359132409,2
56041,225,105,6,6,0,120,0.826807335,2
56043,18,18,3,3,0,0,0.287975639,2
56045,12,12,2,2,0,0,0.442694068,0
72001,,,4,4,,0,,0
72005,124,124,8,8,0,0,0.688643396,2
72009,150,150,6,6,0,0,0.441844761,2
72013,292,292,14,14,16,0,1.324784994,5
72021,584,584,135,135,0,0,1.898188412,9
72023,43,43,0,0,0,0,0.388403952,0
72025,665,665,64,64,0,0,1.124192894,6
72031,233,233,8,8,15,0,0.547016263,2
72035,60,60,0,0,0,0,0.712191761,0
72041,216,216,0,0,0,0,0.817744792,0
72053,222,222,21,21,0,0,1.179769501,4
72069,296,296,39,39,0,0,1.454966456,6
72091,513,513,28,28,0,0,1.574231029,5
72097,158,158,41,41,0,0,0.40665856,2
72099,106,106,7,7,0,0,0.468053758,2
72113,762,762,111,111,22,0,2.497377932,9
72125,232,232,18,18,12,0,1.112847149,4
72127,2092,2092,275,275,52,0,7.697362691,26
72141,7,7,1,1,0,0,0.438356161,0
72145,130,130,78,78,0,0,0.265669137,4
72153,84,84,11,11,0,0,0.478310496,2